,specimen_collection_date,race_ethnicity,new_confirmed_cases,cumulative_confirmed_cases,last_updated_at
0,2020-03-13T00:00:00.000,Asian,3,7,2021-08-06T16:00:02.303
1,2020-03-14T00:00:00.000,Asian,2,9,2021-08-06T16:00:02.303
2,2020-03-15T00:00:00.000,Asian,2,11,2021-08-06T16:00:02.303
3,2020-03-16T00:00:00.000,Asian,8,19,2021-08-06T16:00:02.303
4,2020-03-17T00:00:00.000,Asian,4,23,2021-08-06T16:00:02.303
5,2020-03-18T00:00:00.000,Asian,0,23,2021-08-06T16:00:02.303
6,2020-03-19T00:00:00.000,Asian,3,26,2021-08-06T16:00:02.303
7,2020-03-20T00:00:00.000,Asian,7,33,2021-08-06T16:00:02.303
8,2020-03-21T00:00:00.000,Asian,3,36,2021-08-06T16:00:02.303
9,2020-03-22T00:00:00.000,Asian,3,39,2021-08-06T16:00:02.303
10,2020-03-23T00:00:00.000,Asian,2,41,2021-08-06T16:00:02.303
11,2020-03-24T00:00:00.000,Asian,6,47,2021-08-06T16:00:02.303
12,2020-03-25T00:00:00.000,Asian,9,56,2021-08-06T16:00:02.303
13,2020-03-26T00:00:00.000,Asian,4,60,2021-08-06T16:00:02.303
14,2020-03-27T00:00:00.000,Asian,9,69,2021-08-06T16:00:02.303
15,2020-03-28T00:00:00.000,Asian,2,71,2021-08-06T16:00:02.303
16,2020-03-29T00:00:00.000,Asian,5,76,2021-08-06T16:00:02.303
17,2020-03-30T00:00:00.000,Asian,11,87,2021-08-06T16:00:02.303
18,2020-03-31T00:00:00.000,Asian,11,98,2021-08-06T16:00:02.303
19,2020-04-01T00:00:00.000,Asian,9,107,2021-08-06T16:00:02.303
20,2020-04-02T00:00:00.000,Asian,9,116,2021-08-06T16:00:02.303
21,2020-04-03T00:00:00.000,Asian,6,122,2021-08-06T16:00:02.303
22,2020-04-04T00:00:00.000,Asian,1,123,2021-08-06T16:00:02.303
23,2020-04-05T00:00:00.000,Asian,9,132,2021-08-06T16:00:02.303
24,2020-04-06T00:00:00.000,Asian,5,137,2021-08-06T16:00:02.303
25,2020-04-07T00:00:00.000,Asian,8,145,2021-08-06T16:00:02.303
26,2020-04-08T00:00:00.000,Asian,4,149,2021-08-06T16:00:02.303
27,2020-04-09T00:00:00.000,Asian,6,155,2021-08-06T16:00:02.303
28,2020-04-10T00:00:00.000,Asian,9,164,2021-08-06T16:00:02.303
29,2020-04-11T00:00:00.000,Asian,5,169,2021-08-06T16:00:02.303
30,2020-04-12T00:00:00.000,Asian,3,172,2021-08-06T16:00:02.303
31,2020-04-13T00:00:00.000,Asian,9,181,2021-08-06T16:00:02.303
32,2020-04-14T00:00:00.000,Asian,10,191,2021-08-06T16:00:02.303
33,2020-04-15T00:00:00.000,Asian,8,199,2021-08-06T16:00:02.303
34,2020-04-16T00:00:00.000,Asian,3,202,2021-08-06T16:00:02.303
35,2020-04-17T00:00:00.000,Asian,8,210,2021-08-06T16:00:02.303
36,2020-04-18T00:00:00.000,Asian,0,210,2021-08-06T16:00:02.303
37,2020-04-19T00:00:00.000,Asian,1,211,2021-08-06T16:00:02.303
38,2020-04-20T00:00:00.000,Asian,4,215,2021-08-06T16:00:02.303
39,2020-04-21T00:00:00.000,Asian,6,221,2021-08-06T16:00:02.303
40,2020-04-22T00:00:00.000,Asian,3,224,2021-08-06T16:00:02.303
41,2020-04-23T00:00:00.000,Asian,7,231,2021-08-06T16:00:02.303
42,2020-04-24T00:00:00.000,Asian,4,235,2021-08-06T16:00:02.303
43,2020-04-25T00:00:00.000,Asian,5,240,2021-08-06T16:00:02.303
44,2020-04-26T00:00:00.000,Asian,4,244,2021-08-06T16:00:02.303
45,2020-04-27T00:00:00.000,Asian,2,246,2021-08-06T16:00:02.303
46,2020-04-28T00:00:00.000,Asian,6,252,2021-08-06T16:00:02.303
47,2020-04-29T00:00:00.000,Asian,9,261,2021-08-06T16:00:02.303
48,2020-04-30T00:00:00.000,Asian,6,267,2021-08-06T16:00:02.303
49,2020-05-01T00:00:00.000,Asian,4,271,2021-08-06T16:00:02.303
50,2020-05-02T00:00:00.000,Asian,4,275,2021-08-06T16:00:02.303
51,2020-05-03T00:00:00.000,Asian,1,276,2021-08-06T16:00:02.303
52,2020-05-04T00:00:00.000,Asian,1,277,2021-08-06T16:00:02.303
53,2020-05-05T00:00:00.000,Asian,3,280,2021-08-06T16:00:02.303
54,2020-05-06T00:00:00.000,Asian,4,284,2021-08-06T16:00:02.303
55,2020-05-07T00:00:00.000,Asian,1,285,2021-08-06T16:00:02.303
56,2020-05-08T00:00:00.000,Asian,2,287,2021-08-06T16:00:02.303
57,2020-05-09T00:00:00.000,Asian,1,288,2021-08-06T16:00:02.303
58,2020-05-10T00:00:00.000,Asian,0,288,2021-08-06T16:00:02.303
59,2020-05-11T00:00:00.000,Asian,3,291,2021-08-06T16:00:02.303
60,2020-05-12T00:00:00.000,Asian,12,303,2021-08-06T16:00:02.303
61,2020-05-13T00:00:00.000,Asian,2,305,2021-08-06T16:00:02.303
62,2020-05-14T00:00:00.000,Asian,4,309,2021-08-06T16:00:02.303
63,2020-05-15T00:00:00.000,Asian,4,313,2021-08-06T16:00:02.303
64,2020-05-16T00:00:00.000,Asian,4,317,2021-08-06T16:00:02.303
65,2020-05-17T00:00:00.000,Asian,1,318,2021-08-06T16:00:02.303
66,2020-05-18T00:00:00.000,Asian,4,322,2021-08-06T16:00:02.303
67,2020-05-19T00:00:00.000,Asian,0,322,2021-08-06T16:00:02.303
68,2020-05-20T00:00:00.000,Asian,3,325,2021-08-06T16:00:02.303
69,2020-05-21T00:00:00.000,Asian,8,333,2021-08-06T16:00:02.303
70,2020-05-22T00:00:00.000,Asian,0,333,2021-08-06T16:00:02.303
71,2020-05-23T00:00:00.000,Asian,3,336,2021-08-06T16:00:02.303
72,2020-05-24T00:00:00.000,Asian,1,337,2021-08-06T16:00:02.303
73,2020-05-25T00:00:00.000,Asian,0,337,2021-08-06T16:00:02.303
74,2020-05-26T00:00:00.000,Asian,6,343,2021-08-06T16:00:02.303
75,2020-05-27T00:00:00.000,Asian,5,348,2021-08-06T16:00:02.303
76,2020-05-28T00:00:00.000,Asian,3,351,2021-08-06T16:00:02.303
77,2020-05-29T00:00:00.000,Asian,1,352,2021-08-06T16:00:02.303
78,2020-05-30T00:00:00.000,Asian,3,355,2021-08-06T16:00:02.303
79,2020-05-31T00:00:00.000,Asian,5,360,2021-08-06T16:00:02.303
80,2020-06-01T00:00:00.000,Asian,5,365,2021-08-06T16:00:02.303
81,2020-06-02T00:00:00.000,Asian,4,369,2021-08-06T16:00:02.303
82,2020-06-03T00:00:00.000,Asian,2,371,2021-08-06T16:00:02.303
83,2020-06-04T00:00:00.000,Asian,5,376,2021-08-06T16:00:02.303
84,2020-06-05T00:00:00.000,Asian,2,378,2021-08-06T16:00:02.303
85,2020-06-06T00:00:00.000,Asian,1,379,2021-08-06T16:00:02.303
86,2020-06-07T00:00:00.000,Asian,0,379,2021-08-06T16:00:02.303
87,2020-06-08T00:00:00.000,Asian,5,384,2021-08-06T16:00:02.303
88,2020-06-09T00:00:00.000,Asian,4,388,2021-08-06T16:00:02.303
89,2020-06-10T00:00:00.000,Asian,3,391,2021-08-06T16:00:02.303
90,2020-06-11T00:00:00.000,Asian,2,393,2021-08-06T16:00:02.303
91,2020-06-12T00:00:00.000,Asian,1,394,2021-08-06T16:00:02.303
92,2020-06-13T00:00:00.000,Asian,2,396,2021-08-06T16:00:02.303
93,2020-06-14T00:00:00.000,Asian,1,397,2021-08-06T16:00:02.303
94,2020-06-15T00:00:00.000,Asian,1,398,2021-08-06T16:00:02.303
95,2020-06-16T00:00:00.000,Asian,3,401,2021-08-06T16:00:02.303
96,2020-06-17T00:00:00.000,Asian,2,403,2021-08-06T16:00:02.303
97,2020-06-18T00:00:00.000,Asian,5,408,2021-08-06T16:00:02.303
98,2020-06-19T00:00:00.000,Asian,2,410,2021-08-06T16:00:02.303
99,2020-06-20T00:00:00.000,Asian,7,417,2021-08-06T16:00:02.303
100,2020-06-21T00:00:00.000,Asian,3,420,2021-08-06T16:00:02.303
101,2020-06-22T00:00:00.000,Asian,7,427,2021-08-06T16:00:02.303
102,2020-06-23T00:00:00.000,Asian,11,438,2021-08-06T16:00:02.303
103,2020-06-24T00:00:00.000,Asian,6,444,2021-08-06T16:00:02.303
104,2020-06-25T00:00:00.000,Asian,11,455,2021-08-06T16:00:02.303
105,2020-06-26T00:00:00.000,Asian,6,461,2021-08-06T16:00:02.303
106,2020-06-27T00:00:00.000,Asian,2,463,2021-08-06T16:00:02.303
107,2020-06-28T00:00:00.000,Asian,4,467,2021-08-06T16:00:02.303
108,2020-06-29T00:00:00.000,Asian,11,478,2021-08-06T16:00:02.303
109,2020-06-30T00:00:00.000,Asian,15,493,2021-08-06T16:00:02.303
110,2020-07-01T00:00:00.000,Asian,7,500,2021-08-06T16:00:02.303
111,2020-07-02T00:00:00.000,Asian,7,507,2021-08-06T16:00:02.303
112,2020-07-03T00:00:00.000,Asian,7,514,2021-08-06T16:00:02.303
113,2020-07-04T00:00:00.000,Asian,0,514,2021-08-06T16:00:02.303
114,2020-07-05T00:00:00.000,Asian,6,520,2021-08-06T16:00:02.303
115,2020-07-06T00:00:00.000,Asian,13,533,2021-08-06T16:00:02.303
116,2020-07-07T00:00:00.000,Asian,12,545,2021-08-06T16:00:02.303
117,2020-07-08T00:00:00.000,Asian,6,551,2021-08-06T16:00:02.303
118,2020-07-09T00:00:00.000,Asian,11,562,2021-08-06T16:00:02.303
119,2020-07-10T00:00:00.000,Asian,7,569,2021-08-06T16:00:02.303
120,2020-07-11T00:00:00.000,Asian,5,574,2021-08-06T16:00:02.303
121,2020-07-12T00:00:00.000,Asian,8,582,2021-08-06T16:00:02.303
122,2020-07-13T00:00:00.000,Asian,7,589,2021-08-06T16:00:02.303
123,2020-07-14T00:00:00.000,Asian,16,605,2021-08-06T16:00:02.303
124,2020-07-15T00:00:00.000,Asian,15,620,2021-08-06T16:00:02.303
125,2020-07-16T00:00:00.000,Asian,8,628,2021-08-06T16:00:02.303
126,2020-07-17T00:00:00.000,Asian,8,636,2021-08-06T16:00:02.303
127,2020-07-18T00:00:00.000,Asian,6,642,2021-08-06T16:00:02.303
128,2020-07-19T00:00:00.000,Asian,4,646,2021-08-06T16:00:02.303
129,2020-07-20T00:00:00.000,Asian,11,657,2021-08-06T16:00:02.303
130,2020-07-21T00:00:00.000,Asian,12,669,2021-08-06T16:00:02.303
131,2020-07-22T00:00:00.000,Asian,11,680,2021-08-06T16:00:02.303
132,2020-07-23T00:00:00.000,Asian,12,692,2021-08-06T16:00:02.303
133,2020-07-24T00:00:00.000,Asian,9,701,2021-08-06T16:00:02.303
134,2020-07-25T00:00:00.000,Asian,5,706,2021-08-06T16:00:02.303
135,2020-07-26T00:00:00.000,Asian,5,711,2021-08-06T16:00:02.303
136,2020-07-27T00:00:00.000,Asian,8,719,2021-08-06T16:00:02.303
137,2020-07-28T00:00:00.000,Asian,5,724,2021-08-06T16:00:02.303
138,2020-07-29T00:00:00.000,Asian,15,739,2021-08-06T16:00:02.303
139,2020-07-30T00:00:00.000,Asian,17,756,2021-08-06T16:00:02.303
140,2020-07-31T00:00:00.000,Asian,20,776,2021-08-06T16:00:02.303
141,2020-08-01T00:00:00.000,Asian,11,787,2021-08-06T16:00:02.303
142,2020-08-02T00:00:00.000,Asian,8,795,2021-08-06T16:00:02.303
143,2020-08-03T00:00:00.000,Asian,7,802,2021-08-06T16:00:02.303
144,2020-08-04T00:00:00.000,Asian,8,810,2021-08-06T16:00:02.303
145,2020-08-05T00:00:00.000,Asian,14,824,2021-08-06T16:00:02.303
146,2020-08-06T00:00:00.000,Asian,9,833,2021-08-06T16:00:02.303
147,2020-08-07T00:00:00.000,Asian,11,844,2021-08-06T16:00:02.303
148,2020-08-08T00:00:00.000,Asian,4,848,2021-08-06T16:00:02.303
149,2020-08-09T00:00:00.000,Asian,3,851,2021-08-06T16:00:02.303
150,2020-08-10T00:00:00.000,Asian,12,863,2021-08-06T16:00:02.303
151,2020-08-11T00:00:00.000,Asian,7,870,2021-08-06T16:00:02.303
152,2020-08-12T00:00:00.000,Asian,10,880,2021-08-06T16:00:02.303
153,2020-08-13T00:00:00.000,Asian,8,888,2021-08-06T16:00:02.303
154,2020-08-14T00:00:00.000,Asian,23,911,2021-08-06T16:00:02.303
155,2020-08-15T00:00:00.000,Asian,16,927,2021-08-06T16:00:02.303
156,2020-08-16T00:00:00.000,Asian,8,935,2021-08-06T16:00:02.303
157,2020-08-17T00:00:00.000,Asian,8,943,2021-08-06T16:00:02.303
158,2020-08-18T00:00:00.000,Asian,15,958,2021-08-06T16:00:02.303
159,2020-08-19T00:00:00.000,Asian,12,970,2021-08-06T16:00:02.303
160,2020-08-20T00:00:00.000,Asian,12,982,2021-08-06T16:00:02.303
161,2020-08-21T00:00:00.000,Asian,16,998,2021-08-06T16:00:02.303
162,2020-08-22T00:00:00.000,Asian,10,1008,2021-08-06T16:00:02.303
163,2020-08-23T00:00:00.000,Asian,8,1016,2021-08-06T16:00:02.303
164,2020-08-24T00:00:00.000,Asian,11,1027,2021-08-06T16:00:02.303
165,2020-08-25T00:00:00.000,Asian,10,1037,2021-08-06T16:00:02.303
166,2020-08-26T00:00:00.000,Asian,17,1054,2021-08-06T16:00:02.303
167,2020-08-27T00:00:00.000,Asian,17,1071,2021-08-06T16:00:02.303
168,2020-08-28T00:00:00.000,Asian,9,1080,2021-08-06T16:00:02.303
169,2020-08-29T00:00:00.000,Asian,8,1088,2021-08-06T16:00:02.303
170,2020-08-30T00:00:00.000,Asian,4,1092,2021-08-06T16:00:02.303
171,2020-08-31T00:00:00.000,Asian,17,1109,2021-08-06T16:00:02.303
172,2020-09-01T00:00:00.000,Asian,12,1121,2021-08-06T16:00:02.303
173,2020-09-02T00:00:00.000,Asian,27,1148,2021-08-06T16:00:02.303
174,2020-09-03T00:00:00.000,Asian,18,1166,2021-08-06T16:00:02.303
175,2020-09-04T00:00:00.000,Asian,8,1174,2021-08-06T16:00:02.303
176,2020-09-05T00:00:00.000,Asian,8,1182,2021-08-06T16:00:02.303
177,2020-09-06T00:00:00.000,Asian,6,1188,2021-08-06T16:00:02.303
178,2020-09-07T00:00:00.000,Asian,12,1200,2021-08-06T16:00:02.303
179,2020-09-08T00:00:00.000,Asian,13,1213,2021-08-06T16:00:02.303
180,2020-09-09T00:00:00.000,Asian,23,1236,2021-08-06T16:00:02.303
181,2020-09-10T00:00:00.000,Asian,11,1247,2021-08-06T16:00:02.303
182,2020-09-11T00:00:00.000,Asian,31,1278,2021-08-06T16:00:02.303
183,2020-09-12T00:00:00.000,Asian,8,1286,2021-08-06T16:00:02.303
184,2020-09-13T00:00:00.000,Asian,3,1289,2021-08-06T16:00:02.303
185,2020-09-14T00:00:00.000,Asian,14,1303,2021-08-06T16:00:02.303
186,2020-09-15T00:00:00.000,Asian,18,1321,2021-08-06T16:00:02.303
187,2020-09-16T00:00:00.000,Asian,6,1327,2021-08-06T16:00:02.303
188,2020-09-17T00:00:00.000,Asian,7,1334,2021-08-06T16:00:02.303
189,2020-09-18T00:00:00.000,Asian,12,1346,2021-08-06T16:00:02.303
190,2020-09-19T00:00:00.000,Asian,6,1352,2021-08-06T16:00:02.303
191,2020-09-20T00:00:00.000,Asian,5,1357,2021-08-06T16:00:02.303
192,2020-09-21T00:00:00.000,Asian,6,1363,2021-08-06T16:00:02.303
193,2020-09-22T00:00:00.000,Asian,10,1373,2021-08-06T16:00:02.303
194,2020-09-23T00:00:00.000,Asian,8,1381,2021-08-06T16:00:02.303
195,2020-09-24T00:00:00.000,Asian,11,1392,2021-08-06T16:00:02.303
196,2020-09-25T00:00:00.000,Asian,14,1406,2021-08-06T16:00:02.303
197,2020-09-26T00:00:00.000,Asian,2,1408,2021-08-06T16:00:02.303
198,2020-09-27T00:00:00.000,Asian,4,1412,2021-08-06T16:00:02.303
199,2020-09-28T00:00:00.000,Asian,8,1420,2021-08-06T16:00:02.303
200,2020-09-29T00:00:00.000,Asian,10,1430,2021-08-06T16:00:02.303
201,2020-09-30T00:00:00.000,Asian,13,1443,2021-08-06T16:00:02.303
202,2020-10-01T00:00:00.000,Asian,4,1447,2021-08-06T16:00:02.303
203,2020-10-02T00:00:00.000,Asian,6,1453,2021-08-06T16:00:02.303
204,2020-10-03T00:00:00.000,Asian,4,1457,2021-08-06T16:00:02.303
205,2020-10-04T00:00:00.000,Asian,3,1460,2021-08-06T16:00:02.303
206,2020-10-05T00:00:00.000,Asian,3,1463,2021-08-06T16:00:02.303
207,2020-10-06T00:00:00.000,Asian,6,1469,2021-08-06T16:00:02.303
208,2020-10-07T00:00:00.000,Asian,4,1473,2021-08-06T16:00:02.303
209,2020-10-08T00:00:00.000,Asian,1,1474,2021-08-06T16:00:02.303
210,2020-10-09T00:00:00.000,Asian,5,1479,2021-08-06T16:00:02.303
211,2020-10-10T00:00:00.000,Asian,3,1482,2021-08-06T16:00:02.303
212,2020-10-11T00:00:00.000,Asian,2,1484,2021-08-06T16:00:02.303
213,2020-10-12T00:00:00.000,Asian,4,1488,2021-08-06T16:00:02.303
214,2020-10-13T00:00:00.000,Asian,2,1490,2021-08-06T16:00:02.303
215,2020-10-14T00:00:00.000,Asian,5,1495,2021-08-06T16:00:02.303
216,2020-10-15T00:00:00.000,Asian,4,1499,2021-08-06T16:00:02.303
217,2020-10-16T00:00:00.000,Asian,3,1502,2021-08-06T16:00:02.303
218,2020-10-17T00:00:00.000,Asian,5,1507,2021-08-06T16:00:02.303
219,2020-10-18T00:00:00.000,Asian,0,1507,2021-08-06T16:00:02.303
220,2020-10-19T00:00:00.000,Asian,9,1516,2021-08-06T16:00:02.303
221,2020-10-20T00:00:00.000,Asian,1,1517,2021-08-06T16:00:02.303
222,2020-10-21T00:00:00.000,Asian,3,1520,2021-08-06T16:00:02.303
223,2020-10-22T00:00:00.000,Asian,8,1528,2021-08-06T16:00:02.303
224,2020-10-23T00:00:00.000,Asian,6,1534,2021-08-06T16:00:02.303
225,2020-10-24T00:00:00.000,Asian,4,1538,2021-08-06T16:00:02.303
226,2020-10-25T00:00:00.000,Asian,7,1545,2021-08-06T16:00:02.303
227,2020-10-26T00:00:00.000,Asian,7,1552,2021-08-06T16:00:02.303
228,2020-10-27T00:00:00.000,Asian,9,1561,2021-08-06T16:00:02.303
229,2020-10-28T00:00:00.000,Asian,9,1570,2021-08-06T16:00:02.303
230,2020-10-29T00:00:00.000,Asian,3,1573,2021-08-06T16:00:02.303
231,2020-10-30T00:00:00.000,Asian,6,1579,2021-08-06T16:00:02.303
232,2020-10-31T00:00:00.000,Asian,9,1588,2021-08-06T16:00:02.303
233,2020-11-01T00:00:00.000,Asian,4,1592,2021-08-06T16:00:02.303
234,2020-11-02T00:00:00.000,Asian,15,1607,2021-08-06T16:00:02.303
235,2020-11-03T00:00:00.000,Asian,16,1623,2021-08-06T16:00:02.303
236,2020-11-04T00:00:00.000,Asian,27,1650,2021-08-06T16:00:02.303
237,2020-11-05T00:00:00.000,Asian,14,1664,2021-08-06T16:00:02.303
238,2020-11-06T00:00:00.000,Asian,9,1673,2021-08-06T16:00:02.303
239,2020-11-07T00:00:00.000,Asian,10,1683,2021-08-06T16:00:02.303
240,2020-11-08T00:00:00.000,Asian,2,1685,2021-08-06T16:00:02.303
241,2020-11-09T00:00:00.000,Asian,14,1699,2021-08-06T16:00:02.303
242,2020-11-10T00:00:00.000,Asian,12,1711,2021-08-06T16:00:02.303
243,2020-11-11T00:00:00.000,Asian,14,1725,2021-08-06T16:00:02.303
244,2020-11-12T00:00:00.000,Asian,26,1751,2021-08-06T16:00:02.303
245,2020-11-13T00:00:00.000,Asian,19,1770,2021-08-06T16:00:02.303
246,2020-11-14T00:00:00.000,Asian,13,1783,2021-08-06T16:00:02.303
247,2020-11-15T00:00:00.000,Asian,9,1792,2021-08-06T16:00:02.303
248,2020-11-16T00:00:00.000,Asian,38,1830,2021-08-06T16:00:02.303
249,2020-11-17T00:00:00.000,Asian,24,1854,2021-08-06T16:00:02.303
250,2020-11-18T00:00:00.000,Asian,36,1890,2021-08-06T16:00:02.303
251,2020-11-19T00:00:00.000,Asian,22,1912,2021-08-06T16:00:02.303
252,2020-11-20T00:00:00.000,Asian,16,1928,2021-08-06T16:00:02.303
253,2020-11-21T00:00:00.000,Asian,16,1944,2021-08-06T16:00:02.303
254,2020-11-22T00:00:00.000,Asian,9,1953,2021-08-06T16:00:02.303
255,2020-11-23T00:00:00.000,Asian,25,1978,2021-08-06T16:00:02.303
256,2020-11-24T00:00:00.000,Asian,25,2003,2021-08-06T16:00:02.303
257,2020-11-25T00:00:00.000,Asian,22,2025,2021-08-06T16:00:02.303
258,2020-11-26T00:00:00.000,Asian,19,2044,2021-08-06T16:00:02.303
259,2020-11-27T00:00:00.000,Asian,31,2075,2021-08-06T16:00:02.303
260,2020-11-28T00:00:00.000,Asian,27,2102,2021-08-06T16:00:02.303
261,2020-11-29T00:00:00.000,Asian,18,2120,2021-08-06T16:00:02.303
262,2020-11-30T00:00:00.000,Asian,63,2183,2021-08-06T16:00:02.303
263,2020-12-01T00:00:00.000,Asian,54,2237,2021-08-06T16:00:02.303
264,2020-12-02T00:00:00.000,Asian,58,2295,2021-08-06T16:00:02.303
265,2020-12-03T00:00:00.000,Asian,40,2335,2021-08-06T16:00:02.303
266,2020-12-04T00:00:00.000,Asian,42,2377,2021-08-06T16:00:02.303
267,2020-12-05T00:00:00.000,Asian,36,2413,2021-08-06T16:00:02.303
268,2020-12-06T00:00:00.000,Asian,27,2440,2021-08-06T16:00:02.303
269,2020-12-07T00:00:00.000,Asian,68,2508,2021-08-06T16:00:02.303
270,2020-12-08T00:00:00.000,Asian,76,2584,2021-08-06T16:00:02.303
271,2020-12-09T00:00:00.000,Asian,67,2651,2021-08-06T16:00:02.303
272,2020-12-10T00:00:00.000,Asian,55,2706,2021-08-06T16:00:02.303
273,2020-12-11T00:00:00.000,Asian,77,2783,2021-08-06T16:00:02.303
274,2020-12-12T00:00:00.000,Asian,42,2825,2021-08-06T16:00:02.303
275,2020-12-13T00:00:00.000,Asian,34,2859,2021-08-06T16:00:02.303
276,2020-12-14T00:00:00.000,Asian,69,2928,2021-08-06T16:00:02.303
277,2020-12-15T00:00:00.000,Asian,99,3027,2021-08-06T16:00:02.303
278,2020-12-16T00:00:00.000,Asian,81,3108,2021-08-06T16:00:02.303
279,2020-12-17T00:00:00.000,Asian,45,3153,2021-08-06T16:00:02.303
280,2020-12-18T00:00:00.000,Asian,53,3206,2021-08-06T16:00:02.303
281,2020-12-19T00:00:00.000,Asian,30,3236,2021-08-06T16:00:02.303
282,2020-12-20T00:00:00.000,Asian,17,3253,2021-08-06T16:00:02.303
283,2020-12-21T00:00:00.000,Asian,58,3311,2021-08-06T16:00:02.303
284,2020-12-22T00:00:00.000,Asian,70,3381,2021-08-06T16:00:02.303
285,2020-12-23T00:00:00.000,Asian,67,3448,2021-08-06T16:00:02.303
286,2020-12-24T00:00:00.000,Asian,45,3493,2021-08-06T16:00:02.303
287,2020-12-25T00:00:00.000,Asian,26,3519,2021-08-06T16:00:02.303
288,2020-12-26T00:00:00.000,Asian,57,3576,2021-08-06T16:00:02.303
289,2020-12-27T00:00:00.000,Asian,37,3613,2021-08-06T16:00:02.303
290,2020-12-28T00:00:00.000,Asian,79,3692,2021-08-06T16:00:02.303
291,2020-12-29T00:00:00.000,Asian,98,3790,2021-08-06T16:00:02.303
292,2020-12-30T00:00:00.000,Asian,107,3897,2021-08-06T16:00:02.303
293,2020-12-31T00:00:00.000,Asian,43,3940,2021-08-06T16:00:02.303
294,2021-01-01T00:00:00.000,Asian,13,3953,2021-08-06T16:00:02.303
295,2021-01-02T00:00:00.000,Asian,48,4001,2021-08-06T16:00:02.303
296,2021-01-03T00:00:00.000,Asian,40,4041,2021-08-06T16:00:02.303
297,2021-01-04T00:00:00.000,Asian,125,4166,2021-08-06T16:00:02.303
298,2021-01-05T00:00:00.000,Asian,85,4251,2021-08-06T16:00:02.303
299,2021-01-06T00:00:00.000,Asian,83,4334,2021-08-06T16:00:02.303
300,2021-01-07T00:00:00.000,Asian,91,4425,2021-08-06T16:00:02.303
301,2021-01-08T00:00:00.000,Asian,87,4512,2021-08-06T16:00:02.303
302,2021-01-09T00:00:00.000,Asian,55,4567,2021-08-06T16:00:02.303
303,2021-01-10T00:00:00.000,Asian,17,4584,2021-08-06T16:00:02.303
304,2021-01-11T00:00:00.000,Asian,89,4673,2021-08-06T16:00:02.303
305,2021-01-12T00:00:00.000,Asian,65,4738,2021-08-06T16:00:02.303
306,2021-01-13T00:00:00.000,Asian,84,4822,2021-08-06T16:00:02.303
307,2021-01-14T00:00:00.000,Asian,72,4894,2021-08-06T16:00:02.303
308,2021-01-15T00:00:00.000,Asian,63,4957,2021-08-06T16:00:02.303
309,2021-01-16T00:00:00.000,Asian,51,5008,2021-08-06T16:00:02.303
310,2021-01-17T00:00:00.000,Asian,30,5038,2021-08-06T16:00:02.303
311,2021-01-18T00:00:00.000,Asian,37,5075,2021-08-06T16:00:02.303
312,2021-01-19T00:00:00.000,Asian,37,5112,2021-08-06T16:00:02.303
313,2021-01-20T00:00:00.000,Asian,71,5183,2021-08-06T16:00:02.303
314,2021-01-21T00:00:00.000,Asian,41,5224,2021-08-06T16:00:02.303
315,2021-01-22T00:00:00.000,Asian,41,5265,2021-08-06T16:00:02.303
316,2021-01-23T00:00:00.000,Asian,21,5286,2021-08-06T16:00:02.303
317,2021-01-24T00:00:00.000,Asian,17,5303,2021-08-06T16:00:02.303
318,2021-01-25T00:00:00.000,Asian,48,5351,2021-08-06T16:00:02.303
319,2021-01-26T00:00:00.000,Asian,25,5376,2021-08-06T16:00:02.303
320,2021-01-27T00:00:00.000,Asian,44,5420,2021-08-06T16:00:02.303
321,2021-01-28T00:00:00.000,Asian,45,5465,2021-08-06T16:00:02.303
322,2021-01-29T00:00:00.000,Asian,27,5492,2021-08-06T16:00:02.303
323,2021-01-30T00:00:00.000,Asian,30,5522,2021-08-06T16:00:02.303
324,2021-01-31T00:00:00.000,Asian,29,5551,2021-08-06T16:00:02.303
325,2021-02-01T00:00:00.000,Asian,34,5585,2021-08-06T16:00:02.303
326,2021-02-02T00:00:00.000,Asian,34,5619,2021-08-06T16:00:02.303
327,2021-02-03T00:00:00.000,Asian,60,5679,2021-08-06T16:00:02.303
328,2021-02-04T00:00:00.000,Asian,51,5730,2021-08-06T16:00:02.303
329,2021-02-05T00:00:00.000,Asian,30,5760,2021-08-06T16:00:02.303
330,2021-02-06T00:00:00.000,Asian,35,5795,2021-08-06T16:00:02.303
331,2021-02-07T00:00:00.000,Asian,18,5813,2021-08-06T16:00:02.303
332,2021-02-08T00:00:00.000,Asian,36,5849,2021-08-06T16:00:02.303
333,2021-02-09T00:00:00.000,Asian,28,5877,2021-08-06T16:00:02.303
334,2021-02-10T00:00:00.000,Asian,34,5911,2021-08-06T16:00:02.303
335,2021-02-11T00:00:00.000,Asian,28,5939,2021-08-06T16:00:02.303
336,2021-02-12T00:00:00.000,Asian,24,5963,2021-08-06T16:00:02.303
337,2021-02-13T00:00:00.000,Asian,14,5977,2021-08-06T16:00:02.303
338,2021-02-14T00:00:00.000,Asian,12,5989,2021-08-06T16:00:02.303
339,2021-02-15T00:00:00.000,Asian,18,6007,2021-08-06T16:00:02.303
340,2021-02-16T00:00:00.000,Asian,20,6027,2021-08-06T16:00:02.303
341,2021-02-17T00:00:00.000,Asian,28,6055,2021-08-06T16:00:02.303
342,2021-02-18T00:00:00.000,Asian,17,6072,2021-08-06T16:00:02.303
343,2021-02-19T00:00:00.000,Asian,24,6096,2021-08-06T16:00:02.303
344,2021-02-20T00:00:00.000,Asian,9,6105,2021-08-06T16:00:02.303
345,2021-02-21T00:00:00.000,Asian,9,6114,2021-08-06T16:00:02.303
346,2021-02-22T00:00:00.000,Asian,26,6140,2021-08-06T16:00:02.303
347,2021-02-23T00:00:00.000,Asian,17,6157,2021-08-06T16:00:02.303
348,2021-02-24T00:00:00.000,Asian,15,6172,2021-08-06T16:00:02.303
349,2021-02-25T00:00:00.000,Asian,16,6188,2021-08-06T16:00:02.303
350,2021-02-26T00:00:00.000,Asian,10,6198,2021-08-06T16:00:02.303
351,2021-02-27T00:00:00.000,Asian,8,6206,2021-08-06T16:00:02.303
352,2021-02-28T00:00:00.000,Asian,7,6213,2021-08-06T16:00:02.303
353,2021-03-01T00:00:00.000,Asian,10,6223,2021-08-06T16:00:02.303
354,2021-03-02T00:00:00.000,Asian,11,6234,2021-08-06T16:00:02.303
355,2021-03-03T00:00:00.000,Asian,8,6242,2021-08-06T16:00:02.303
356,2021-03-04T00:00:00.000,Asian,6,6248,2021-08-06T16:00:02.303
357,2021-03-05T00:00:00.000,Asian,13,6261,2021-08-06T16:00:02.303
358,2021-03-06T00:00:00.000,Asian,2,6263,2021-08-06T16:00:02.303
359,2021-03-07T00:00:00.000,Asian,4,6267,2021-08-06T16:00:02.303
360,2021-03-08T00:00:00.000,Asian,9,6276,2021-08-06T16:00:02.303
361,2021-03-09T00:00:00.000,Asian,7,6283,2021-08-06T16:00:02.303
362,2021-03-10T00:00:00.000,Asian,6,6289,2021-08-06T16:00:02.303
363,2021-03-11T00:00:00.000,Asian,9,6298,2021-08-06T16:00:02.303
364,2021-03-12T00:00:00.000,Asian,9,6307,2021-08-06T16:00:02.303
365,2021-03-13T00:00:00.000,Asian,4,6311,2021-08-06T16:00:02.303
366,2021-03-14T00:00:00.000,Asian,0,6311,2021-08-06T16:00:02.303
367,2021-03-15T00:00:00.000,Asian,7,6318,2021-08-06T16:00:02.303
368,2021-03-16T00:00:00.000,Asian,4,6322,2021-08-06T16:00:02.303
369,2021-03-17T00:00:00.000,Asian,9,6331,2021-08-06T16:00:02.303
370,2021-03-18T00:00:00.000,Asian,3,6334,2021-08-06T16:00:02.303
371,2021-03-19T00:00:00.000,Asian,12,6346,2021-08-06T16:00:02.303
372,2021-03-20T00:00:00.000,Asian,9,6355,2021-08-06T16:00:02.303
373,2021-03-21T00:00:00.000,Asian,5,6360,2021-08-06T16:00:02.303
374,2021-03-22T00:00:00.000,Asian,6,6366,2021-08-06T16:00:02.303
375,2021-03-23T00:00:00.000,Asian,3,6369,2021-08-06T16:00:02.303
376,2021-03-24T00:00:00.000,Asian,8,6377,2021-08-06T16:00:02.303
377,2021-03-25T00:00:00.000,Asian,11,6388,2021-08-06T16:00:02.303
378,2021-03-26T00:00:00.000,Asian,5,6393,2021-08-06T16:00:02.303
379,2021-03-27T00:00:00.000,Asian,6,6399,2021-08-06T16:00:02.303
380,2021-03-28T00:00:00.000,Asian,3,6402,2021-08-06T16:00:02.303
381,2021-03-29T00:00:00.000,Asian,13,6415,2021-08-06T16:00:02.303
382,2021-03-30T00:00:00.000,Asian,11,6426,2021-08-06T16:00:02.303
383,2021-03-31T00:00:00.000,Asian,10,6436,2021-08-06T16:00:02.303
384,2021-04-01T00:00:00.000,Asian,6,6442,2021-08-06T16:00:02.303
385,2021-04-02T00:00:00.000,Asian,8,6450,2021-08-06T16:00:02.303
386,2021-04-03T00:00:00.000,Asian,3,6453,2021-08-06T16:00:02.303
387,2021-04-04T00:00:00.000,Asian,5,6458,2021-08-06T16:00:02.303
388,2021-04-05T00:00:00.000,Asian,18,6476,2021-08-06T16:00:02.303
389,2021-04-06T00:00:00.000,Asian,6,6482,2021-08-06T16:00:02.303
390,2021-04-07T00:00:00.000,Asian,7,6489,2021-08-06T16:00:02.303
391,2021-04-08T00:00:00.000,Asian,11,6500,2021-08-06T16:00:02.303
392,2021-04-09T00:00:00.000,Asian,5,6505,2021-08-06T16:00:02.303
393,2021-04-10T00:00:00.000,Asian,7,6512,2021-08-06T16:00:02.303
394,2021-04-11T00:00:00.000,Asian,7,6519,2021-08-06T16:00:02.303
395,2021-04-12T00:00:00.000,Asian,7,6526,2021-08-06T16:00:02.303
396,2021-04-13T00:00:00.000,Asian,10,6536,2021-08-06T16:00:02.303
397,2021-04-14T00:00:00.000,Asian,3,6539,2021-08-06T16:00:02.303
398,2021-04-15T00:00:00.000,Asian,5,6544,2021-08-06T16:00:02.303
399,2021-04-16T00:00:00.000,Asian,7,6551,2021-08-06T16:00:02.303
400,2021-04-17T00:00:00.000,Asian,2,6553,2021-08-06T16:00:02.303
401,2021-04-18T00:00:00.000,Asian,2,6555,2021-08-06T16:00:02.303
402,2021-04-19T00:00:00.000,Asian,4,6559,2021-08-06T16:00:02.303
403,2021-04-20T00:00:00.000,Asian,4,6563,2021-08-06T16:00:02.303
404,2021-04-21T00:00:00.000,Asian,8,6571,2021-08-06T16:00:02.303
405,2021-04-22T00:00:00.000,Asian,4,6575,2021-08-06T16:00:02.303
406,2021-04-23T00:00:00.000,Asian,5,6580,2021-08-06T16:00:02.303
407,2021-04-24T00:00:00.000,Asian,2,6582,2021-08-06T16:00:02.303
408,2021-04-25T00:00:00.000,Asian,2,6584,2021-08-06T16:00:02.303
409,2021-04-26T00:00:00.000,Asian,6,6590,2021-08-06T16:00:02.303
410,2021-04-27T00:00:00.000,Asian,3,6593,2021-08-06T16:00:02.303
411,2021-04-28T00:00:00.000,Asian,7,6600,2021-08-06T16:00:02.303
412,2021-04-29T00:00:00.000,Asian,2,6602,2021-08-06T16:00:02.303
413,2021-04-30T00:00:00.000,Asian,2,6604,2021-08-06T16:00:02.303
414,2021-05-01T00:00:00.000,Asian,7,6611,2021-08-06T16:00:02.303
415,2021-05-02T00:00:00.000,Asian,3,6614,2021-08-06T16:00:02.303
416,2021-05-03T00:00:00.000,Asian,2,6616,2021-08-06T16:00:02.303
417,2021-05-04T00:00:00.000,Asian,2,6618,2021-08-06T16:00:02.303
418,2021-05-05T00:00:00.000,Asian,6,6624,2021-08-06T16:00:02.303
419,2021-05-06T00:00:00.000,Asian,1,6625,2021-08-06T16:00:02.303
420,2021-05-07T00:00:00.000,Asian,3,6628,2021-08-06T16:00:02.303
421,2021-05-08T00:00:00.000,Asian,2,6630,2021-08-06T16:00:02.303
422,2021-05-09T00:00:00.000,Asian,1,6631,2021-08-06T16:00:02.303
423,2021-05-10T00:00:00.000,Asian,4,6635,2021-08-06T16:00:02.303
424,2021-05-11T00:00:00.000,Asian,8,6643,2021-08-06T16:00:02.303
425,2021-05-12T00:00:00.000,Asian,6,6649,2021-08-06T16:00:02.303
426,2021-05-13T00:00:00.000,Asian,4,6653,2021-08-06T16:00:02.303
427,2021-05-14T00:00:00.000,Asian,5,6658,2021-08-06T16:00:02.303
428,2021-05-15T00:00:00.000,Asian,0,6658,2021-08-06T16:00:02.303
429,2021-05-16T00:00:00.000,Asian,5,6663,2021-08-06T16:00:02.303
430,2021-05-17T00:00:00.000,Asian,3,6666,2021-08-06T16:00:02.303
431,2021-05-18T00:00:00.000,Asian,2,6668,2021-08-06T16:00:02.303
432,2021-05-19T00:00:00.000,Asian,4,6672,2021-08-06T16:00:02.303
433,2021-05-20T00:00:00.000,Asian,1,6673,2021-08-06T16:00:02.303
434,2021-05-21T00:00:00.000,Asian,0,6673,2021-08-06T16:00:02.303
435,2021-05-22T00:00:00.000,Asian,0,6673,2021-08-06T16:00:02.303
436,2021-05-23T00:00:00.000,Asian,0,6673,2021-08-06T16:00:02.303
437,2021-05-24T00:00:00.000,Asian,2,6675,2021-08-06T16:00:02.303
438,2021-05-25T00:00:00.000,Asian,0,6675,2021-08-06T16:00:02.303
439,2021-05-26T00:00:00.000,Asian,5,6680,2021-08-06T16:00:02.303
440,2021-05-27T00:00:00.000,Asian,2,6682,2021-08-06T16:00:02.303
441,2021-05-28T00:00:00.000,Asian,1,6683,2021-08-06T16:00:02.303
442,2021-05-29T00:00:00.000,Asian,0,6683,2021-08-06T16:00:02.303
443,2021-05-30T00:00:00.000,Asian,1,6684,2021-08-06T16:00:02.303
444,2021-05-31T00:00:00.000,Asian,0,6684,2021-08-06T16:00:02.303
445,2021-06-01T00:00:00.000,Asian,1,6685,2021-08-06T16:00:02.303
446,2021-06-02T00:00:00.000,Asian,2,6687,2021-08-06T16:00:02.303
447,2021-06-03T00:00:00.000,Asian,5,6692,2021-08-06T16:00:02.303
448,2021-06-04T00:00:00.000,Asian,2,6694,2021-08-06T16:00:02.303
449,2021-06-05T00:00:00.000,Asian,2,6696,2021-08-06T16:00:02.303
450,2021-06-06T00:00:00.000,Asian,0,6696,2021-08-06T16:00:02.303
451,2021-06-07T00:00:00.000,Asian,1,6697,2021-08-06T16:00:02.303
452,2021-06-08T00:00:00.000,Asian,0,6697,2021-08-06T16:00:02.303
453,2021-06-09T00:00:00.000,Asian,1,6698,2021-08-06T16:00:02.303
454,2021-06-10T00:00:00.000,Asian,3,6701,2021-08-06T16:00:02.303
455,2021-06-11T00:00:00.000,Asian,1,6702,2021-08-06T16:00:02.303
456,2021-06-12T00:00:00.000,Asian,2,6704,2021-08-06T16:00:02.303
457,2021-06-13T00:00:00.000,Asian,0,6704,2021-08-06T16:00:02.303
458,2021-06-14T00:00:00.000,Asian,0,6704,2021-08-06T16:00:02.303
459,2021-06-15T00:00:00.000,Asian,0,6704,2021-08-06T16:00:02.303
460,2021-06-16T00:00:00.000,Asian,1,6705,2021-08-06T16:00:02.303
461,2021-06-17T00:00:00.000,Asian,3,6708,2021-08-06T16:00:02.303
462,2021-06-18T00:00:00.000,Asian,1,6709,2021-08-06T16:00:02.303
463,2021-06-19T00:00:00.000,Asian,0,6709,2021-08-06T16:00:02.303
464,2021-06-20T00:00:00.000,Asian,0,6709,2021-08-06T16:00:02.303
465,2021-06-21T00:00:00.000,Asian,3,6712,2021-08-06T16:00:02.303
466,2021-06-22T00:00:00.000,Asian,2,6714,2021-08-06T16:00:02.303
467,2021-06-23T00:00:00.000,Asian,1,6715,2021-08-06T16:00:02.303
468,2021-06-24T00:00:00.000,Asian,3,6718,2021-08-06T16:00:02.303
469,2021-06-25T00:00:00.000,Asian,3,6721,2021-08-06T16:00:02.303
470,2021-06-26T00:00:00.000,Asian,1,6722,2021-08-06T16:00:02.303
471,2021-06-27T00:00:00.000,Asian,1,6723,2021-08-06T16:00:02.303
472,2021-06-28T00:00:00.000,Asian,2,6725,2021-08-06T16:00:02.303
473,2021-06-29T00:00:00.000,Asian,13,6738,2021-08-06T16:00:02.303
474,2021-06-30T00:00:00.000,Asian,7,6745,2021-08-06T16:00:02.303
475,2021-07-01T00:00:00.000,Asian,4,6749,2021-08-06T16:00:02.303
476,2021-07-02T00:00:00.000,Asian,9,6758,2021-08-06T16:00:02.303
477,2021-07-03T00:00:00.000,Asian,6,6764,2021-08-06T16:00:02.303
478,2021-07-04T00:00:00.000,Asian,0,6764,2021-08-06T16:00:02.303
479,2021-07-05T00:00:00.000,Asian,4,6768,2021-08-06T16:00:02.303
480,2021-07-06T00:00:00.000,Asian,17,6785,2021-08-06T16:00:02.303
481,2021-07-07T00:00:00.000,Asian,18,6803,2021-08-06T16:00:02.303
482,2021-07-08T00:00:00.000,Asian,26,6829,2021-08-06T16:00:02.303
483,2021-07-09T00:00:00.000,Asian,10,6839,2021-08-06T16:00:02.303
484,2021-07-10T00:00:00.000,Asian,15,6854,2021-08-06T16:00:02.303
485,2021-07-11T00:00:00.000,Asian,9,6863,2021-08-06T16:00:02.303
486,2021-07-12T00:00:00.000,Asian,14,6877,2021-08-06T16:00:02.303
487,2021-07-13T00:00:00.000,Asian,32,6909,2021-08-06T16:00:02.303
488,2021-07-14T00:00:00.000,Asian,20,6929,2021-08-06T16:00:02.303
489,2021-07-15T00:00:00.000,Asian,35,6964,2021-08-06T16:00:02.303
490,2021-07-16T00:00:00.000,Asian,16,6980,2021-08-06T16:00:02.303
491,2021-07-17T00:00:00.000,Asian,11,6991,2021-08-06T16:00:02.303
492,2021-07-18T00:00:00.000,Asian,9,7000,2021-08-06T16:00:02.303
493,2021-07-19T00:00:00.000,Asian,34,7034,2021-08-06T16:00:02.303
494,2021-07-20T00:00:00.000,Asian,41,7075,2021-08-06T16:00:02.303
495,2021-07-21T00:00:00.000,Asian,39,7114,2021-08-06T16:00:02.303
496,2021-07-22T00:00:00.000,Asian,34,7148,2021-08-06T16:00:02.303
497,2021-07-23T00:00:00.000,Asian,30,7178,2021-08-06T16:00:02.303
498,2021-07-24T00:00:00.000,Asian,20,7198,2021-08-06T16:00:02.303
499,2021-07-25T00:00:00.000,Asian,17,7215,2021-08-06T16:00:02.303
500,2021-07-26T00:00:00.000,Asian,37,7252,2021-08-06T16:00:02.303
501,2021-07-27T00:00:00.000,Asian,44,7296,2021-08-06T16:00:02.303
502,2021-07-28T00:00:00.000,Asian,51,7347,2021-08-06T16:00:02.303
503,2021-07-29T00:00:00.000,Asian,68,7415,2021-08-06T16:00:02.303
504,2021-07-30T00:00:00.000,Asian,26,7441,2021-08-06T16:00:02.303
505,2021-07-31T00:00:00.000,Asian,30,7471,2021-08-06T16:00:02.303
506,2021-08-01T00:00:00.000,Asian,22,7493,2021-08-06T16:00:02.303
507,2021-08-02T00:00:00.000,Asian,53,7546,2021-08-06T16:00:02.303
508,2020-04-01T00:00:00.000,Native Hawaiian or Other Pacific Islander,3,7,2021-08-06T16:00:02.303
509,2020-04-02T00:00:00.000,Native Hawaiian or Other Pacific Islander,0,7,2021-08-06T16:00:02.303
510,2020-04-03T00:00:00.000,Native Hawaiian or Other Pacific Islander,0,7,2021-08-06T16:00:02.303
511,2020-04-04T00:00:00.000,Native Hawaiian or Other Pacific Islander,0,7,2021-08-06T16:00:02.303
512,2020-04-05T00:00:00.000,Native Hawaiian or Other Pacific Islander,0,7,2021-08-06T16:00:02.303
513,2020-04-06T00:00:00.000,Native Hawaiian or Other Pacific Islander,1,8,2021-08-06T16:00:02.303
514,2020-04-07T00:00:00.000,Native Hawaiian or Other Pacific Islander,1,9,2021-08-06T16:00:02.303
515,2020-04-08T00:00:00.000,Native Hawaiian or Other Pacific Islander,1,10,2021-08-06T16:00:02.303
516,2020-04-09T00:00:00.000,Native Hawaiian or Other Pacific Islander,1,11,2021-08-06T16:00:02.303
517,2020-04-10T00:00:00.000,Native Hawaiian or Other Pacific Islander,0,11,2021-08-06T16:00:02.303
518,2020-04-11T00:00:00.000,Native Hawaiian or Other Pacific Islander,0,11,2021-08-06T16:00:02.303
519,2020-04-12T00:00:00.000,Native Hawaiian or Other Pacific Islander,2,13,2021-08-06T16:00:02.303
520,2020-04-13T00:00:00.000,Native Hawaiian or Other Pacific Islander,1,14,2021-08-06T16:00:02.303
521,2020-04-14T00:00:00.000,Native Hawaiian or Other Pacific Islander,2,16,2021-08-06T16:00:02.303
522,2020-04-15T00:00:00.000,Native Hawaiian or Other Pacific Islander,0,16,2021-08-06T16:00:02.303
523,2020-04-16T00:00:00.000,Native Hawaiian or Other Pacific Islander,1,17,2021-08-06T16:00:02.303
524,2020-04-17T00:00:00.000,Native Hawaiian or Other Pacific Islander,0,17,2021-08-06T16:00:02.303
525,2020-04-18T00:00:00.000,Native Hawaiian or Other Pacific Islander,0,17,2021-08-06T16:00:02.303
526,2020-04-19T00:00:00.000,Native Hawaiian or Other Pacific Islander,0,17,2021-08-06T16:00:02.303
527,2020-04-20T00:00:00.000,Native Hawaiian or Other Pacific Islander,2,19,2021-08-06T16:00:02.303
528,2020-04-21T00:00:00.000,Native Hawaiian or Other Pacific Islander,0,19,2021-08-06T16:00:02.303
529,2020-04-22T00:00:00.000,Native Hawaiian or Other Pacific Islander,2,21,2021-08-06T16:00:02.303
530,2020-04-23T00:00:00.000,Native Hawaiian or Other Pacific Islander,2,23,2021-08-06T16:00:02.303
531,2020-04-24T00:00:00.000,Native Hawaiian or Other Pacific Islander,2,25,2021-08-06T16:00:02.303
532,2020-04-25T00:00:00.000,Native Hawaiian or Other Pacific Islander,0,25,2021-08-06T16:00:02.303
533,2020-04-26T00:00:00.000,Native Hawaiian or Other Pacific Islander,0,25,2021-08-06T16:00:02.303
534,2020-04-27T00:00:00.000,Native Hawaiian or Other Pacific Islander,1,26,2021-08-06T16:00:02.303
535,2020-04-28T00:00:00.000,Native Hawaiian or Other Pacific Islander,0,26,2021-08-06T16:00:02.303
536,2020-04-29T00:00:00.000,Native Hawaiian or Other Pacific Islander,0,26,2021-08-06T16:00:02.303
537,2020-04-30T00:00:00.000,Native Hawaiian or Other Pacific Islander,0,26,2021-08-06T16:00:02.303
538,2020-05-01T00:00:00.000,Native Hawaiian or Other Pacific Islander,0,26,2021-08-06T16:00:02.303
539,2020-05-02T00:00:00.000,Native Hawaiian or Other Pacific Islander,0,26,2021-08-06T16:00:02.303
540,2020-05-03T00:00:00.000,Native Hawaiian or Other Pacific Islander,0,26,2021-08-06T16:00:02.303
541,2020-05-04T00:00:00.000,Native Hawaiian or Other Pacific Islander,0,26,2021-08-06T16:00:02.303
542,2020-05-05T00:00:00.000,Native Hawaiian or Other Pacific Islander,0,26,2021-08-06T16:00:02.303
543,2020-05-06T00:00:00.000,Native Hawaiian or Other Pacific Islander,0,26,2021-08-06T16:00:02.303
544,2020-05-07T00:00:00.000,Native Hawaiian or Other Pacific Islander,0,26,2021-08-06T16:00:02.303
545,2020-05-08T00:00:00.000,Native Hawaiian or Other Pacific Islander,0,26,2021-08-06T16:00:02.303
546,2020-05-09T00:00:00.000,Native Hawaiian or Other Pacific Islander,0,26,2021-08-06T16:00:02.303
547,2020-05-10T00:00:00.000,Native Hawaiian or Other Pacific Islander,0,26,2021-08-06T16:00:02.303
548,2020-05-11T00:00:00.000,Native Hawaiian or Other Pacific Islander,1,27,2021-08-06T16:00:02.303
549,2020-05-12T00:00:00.000,Native Hawaiian or Other Pacific Islander,0,27,2021-08-06T16:00:02.303
550,2020-05-13T00:00:00.000,Native Hawaiian or Other Pacific Islander,1,28,2021-08-06T16:00:02.303
551,2020-05-14T00:00:00.000,Native Hawaiian or Other Pacific Islander,1,29,2021-08-06T16:00:02.303
552,2020-05-15T00:00:00.000,Native Hawaiian or Other Pacific Islander,1,30,2021-08-06T16:00:02.303
553,2020-05-16T00:00:00.000,Native Hawaiian or Other Pacific Islander,0,30,2021-08-06T16:00:02.303
554,2020-05-17T00:00:00.000,Native Hawaiian or Other Pacific Islander,0,30,2021-08-06T16:00:02.303
555,2020-05-18T00:00:00.000,Native Hawaiian or Other Pacific Islander,0,30,2021-08-06T16:00:02.303
556,2020-05-19T00:00:00.000,Native Hawaiian or Other Pacific Islander,0,30,2021-08-06T16:00:02.303
557,2020-05-20T00:00:00.000,Native Hawaiian or Other Pacific Islander,0,30,2021-08-06T16:00:02.303
558,2020-05-21T00:00:00.000,Native Hawaiian or Other Pacific Islander,0,30,2021-08-06T16:00:02.303
559,2020-05-22T00:00:00.000,Native Hawaiian or Other Pacific Islander,0,30,2021-08-06T16:00:02.303
560,2020-05-23T00:00:00.000,Native Hawaiian or Other Pacific Islander,0,30,2021-08-06T16:00:02.303
561,2020-05-24T00:00:00.000,Native Hawaiian or Other Pacific Islander,0,30,2021-08-06T16:00:02.303
562,2020-05-25T00:00:00.000,Native Hawaiian or Other Pacific Islander,1,31,2021-08-06T16:00:02.303
563,2020-05-26T00:00:00.000,Native Hawaiian or Other Pacific Islander,0,31,2021-08-06T16:00:02.303
564,2020-05-27T00:00:00.000,Native Hawaiian or Other Pacific Islander,0,31,2021-08-06T16:00:02.303
565,2020-05-28T00:00:00.000,Native Hawaiian or Other Pacific Islander,0,31,2021-08-06T16:00:02.303
566,2020-05-29T00:00:00.000,Native Hawaiian or Other Pacific Islander,1,32,2021-08-06T16:00:02.303
567,2020-05-30T00:00:00.000,Native Hawaiian or Other Pacific Islander,0,32,2021-08-06T16:00:02.303
568,2020-05-31T00:00:00.000,Native Hawaiian or Other Pacific Islander,0,32,2021-08-06T16:00:02.303
569,2020-06-01T00:00:00.000,Native Hawaiian or Other Pacific Islander,1,33,2021-08-06T16:00:02.303
570,2020-06-02T00:00:00.000,Native Hawaiian or Other Pacific Islander,0,33,2021-08-06T16:00:02.303
571,2020-06-03T00:00:00.000,Native Hawaiian or Other Pacific Islander,0,33,2021-08-06T16:00:02.303
572,2020-06-04T00:00:00.000,Native Hawaiian or Other Pacific Islander,0,33,2021-08-06T16:00:02.303
573,2020-06-05T00:00:00.000,Native Hawaiian or Other Pacific Islander,0,33,2021-08-06T16:00:02.303
574,2020-06-06T00:00:00.000,Native Hawaiian or Other Pacific Islander,0,33,2021-08-06T16:00:02.303
575,2020-06-07T00:00:00.000,Native Hawaiian or Other Pacific Islander,0,33,2021-08-06T16:00:02.303
576,2020-06-08T00:00:00.000,Native Hawaiian or Other Pacific Islander,0,33,2021-08-06T16:00:02.303
577,2020-06-09T00:00:00.000,Native Hawaiian or Other Pacific Islander,1,34,2021-08-06T16:00:02.303
578,2020-06-10T00:00:00.000,Native Hawaiian or Other Pacific Islander,0,34,2021-08-06T16:00:02.303
579,2020-06-11T00:00:00.000,Native Hawaiian or Other Pacific Islander,0,34,2021-08-06T16:00:02.303
580,2020-06-12T00:00:00.000,Native Hawaiian or Other Pacific Islander,0,34,2021-08-06T16:00:02.303
581,2020-06-13T00:00:00.000,Native Hawaiian or Other Pacific Islander,0,34,2021-08-06T16:00:02.303
582,2020-06-14T00:00:00.000,Native Hawaiian or Other Pacific Islander,0,34,2021-08-06T16:00:02.303
583,2020-06-15T00:00:00.000,Native Hawaiian or Other Pacific Islander,0,34,2021-08-06T16:00:02.303
584,2020-06-16T00:00:00.000,Native Hawaiian or Other Pacific Islander,0,34,2021-08-06T16:00:02.303
585,2020-06-17T00:00:00.000,Native Hawaiian or Other Pacific Islander,0,34,2021-08-06T16:00:02.303
586,2020-06-18T00:00:00.000,Native Hawaiian or Other Pacific Islander,1,35,2021-08-06T16:00:02.303
587,2020-06-19T00:00:00.000,Native Hawaiian or Other Pacific Islander,0,35,2021-08-06T16:00:02.303
588,2020-06-20T00:00:00.000,Native Hawaiian or Other Pacific Islander,0,35,2021-08-06T16:00:02.303
589,2020-06-21T00:00:00.000,Native Hawaiian or Other Pacific Islander,1,36,2021-08-06T16:00:02.303
590,2020-06-22T00:00:00.000,Native Hawaiian or Other Pacific Islander,0,36,2021-08-06T16:00:02.303
591,2020-06-23T00:00:00.000,Native Hawaiian or Other Pacific Islander,0,36,2021-08-06T16:00:02.303
592,2020-06-24T00:00:00.000,Native Hawaiian or Other Pacific Islander,0,36,2021-08-06T16:00:02.303
593,2020-06-25T00:00:00.000,Native Hawaiian or Other Pacific Islander,0,36,2021-08-06T16:00:02.303
594,2020-06-26T00:00:00.000,Native Hawaiian or Other Pacific Islander,0,36,2021-08-06T16:00:02.303
595,2020-06-27T00:00:00.000,Native Hawaiian or Other Pacific Islander,0,36,2021-08-06T16:00:02.303
596,2020-06-28T00:00:00.000,Native Hawaiian or Other Pacific Islander,0,36,2021-08-06T16:00:02.303
597,2020-06-29T00:00:00.000,Native Hawaiian or Other Pacific Islander,1,37,2021-08-06T16:00:02.303
598,2020-06-30T00:00:00.000,Native Hawaiian or Other Pacific Islander,1,38,2021-08-06T16:00:02.303
599,2020-07-01T00:00:00.000,Native Hawaiian or Other Pacific Islander,1,39,2021-08-06T16:00:02.303
600,2020-07-02T00:00:00.000,Native Hawaiian or Other Pacific Islander,1,40,2021-08-06T16:00:02.303
601,2020-07-03T00:00:00.000,Native Hawaiian or Other Pacific Islander,0,40,2021-08-06T16:00:02.303
602,2020-07-04T00:00:00.000,Native Hawaiian or Other Pacific Islander,0,40,2021-08-06T16:00:02.303
603,2020-07-05T00:00:00.000,Native Hawaiian or Other Pacific Islander,2,42,2021-08-06T16:00:02.303
604,2020-07-06T00:00:00.000,Native Hawaiian or Other Pacific Islander,0,42,2021-08-06T16:00:02.303
605,2020-07-07T00:00:00.000,Native Hawaiian or Other Pacific Islander,0,42,2021-08-06T16:00:02.303
606,2020-07-08T00:00:00.000,Native Hawaiian or Other Pacific Islander,2,44,2021-08-06T16:00:02.303
607,2020-07-09T00:00:00.000,Native Hawaiian or Other Pacific Islander,2,46,2021-08-06T16:00:02.303
608,2020-07-10T00:00:00.000,Native Hawaiian or Other Pacific Islander,0,46,2021-08-06T16:00:02.303
609,2020-07-11T00:00:00.000,Native Hawaiian or Other Pacific Islander,3,49,2021-08-06T16:00:02.303
610,2020-07-12T00:00:00.000,Native Hawaiian or Other Pacific Islander,0,49,2021-08-06T16:00:02.303
611,2020-07-13T00:00:00.000,Native Hawaiian or Other Pacific Islander,1,50,2021-08-06T16:00:02.303
612,2020-07-14T00:00:00.000,Native Hawaiian or Other Pacific Islander,1,51,2021-08-06T16:00:02.303
613,2020-07-15T00:00:00.000,Native Hawaiian or Other Pacific Islander,3,54,2021-08-06T16:00:02.303
614,2020-07-16T00:00:00.000,Native Hawaiian or Other Pacific Islander,3,57,2021-08-06T16:00:02.303
615,2020-07-17T00:00:00.000,Native Hawaiian or Other Pacific Islander,0,57,2021-08-06T16:00:02.303
616,2020-07-18T00:00:00.000,Native Hawaiian or Other Pacific Islander,0,57,2021-08-06T16:00:02.303
617,2020-07-19T00:00:00.000,Native Hawaiian or Other Pacific Islander,0,57,2021-08-06T16:00:02.303
618,2020-07-20T00:00:00.000,Native Hawaiian or Other Pacific Islander,4,61,2021-08-06T16:00:02.303
619,2020-07-21T00:00:00.000,Native Hawaiian or Other Pacific Islander,2,63,2021-08-06T16:00:02.303
620,2020-07-22T00:00:00.000,Native Hawaiian or Other Pacific Islander,5,68,2021-08-06T16:00:02.303
621,2020-07-23T00:00:00.000,Native Hawaiian or Other Pacific Islander,3,71,2021-08-06T16:00:02.303
622,2020-07-24T00:00:00.000,Native Hawaiian or Other Pacific Islander,2,73,2021-08-06T16:00:02.303
623,2020-07-25T00:00:00.000,Native Hawaiian or Other Pacific Islander,3,76,2021-08-06T16:00:02.303
624,2020-07-26T00:00:00.000,Native Hawaiian or Other Pacific Islander,0,76,2021-08-06T16:00:02.303
625,2020-07-27T00:00:00.000,Native Hawaiian or Other Pacific Islander,2,78,2021-08-06T16:00:02.303
626,2020-07-28T00:00:00.000,Native Hawaiian or Other Pacific Islander,5,83,2021-08-06T16:00:02.303
627,2020-07-29T00:00:00.000,Native Hawaiian or Other Pacific Islander,1,84,2021-08-06T16:00:02.303
628,2020-07-30T00:00:00.000,Native Hawaiian or Other Pacific Islander,1,85,2021-08-06T16:00:02.303
629,2020-07-31T00:00:00.000,Native Hawaiian or Other Pacific Islander,1,86,2021-08-06T16:00:02.303
630,2020-08-01T00:00:00.000,Native Hawaiian or Other Pacific Islander,1,87,2021-08-06T16:00:02.303
631,2020-08-02T00:00:00.000,Native Hawaiian or Other Pacific Islander,4,91,2021-08-06T16:00:02.303
632,2020-08-03T00:00:00.000,Native Hawaiian or Other Pacific Islander,0,91,2021-08-06T16:00:02.303
633,2020-08-04T00:00:00.000,Native Hawaiian or Other Pacific Islander,0,91,2021-08-06T16:00:02.303
634,2020-08-05T00:00:00.000,Native Hawaiian or Other Pacific Islander,4,95,2021-08-06T16:00:02.303
635,2020-08-06T00:00:00.000,Native Hawaiian or Other Pacific Islander,0,95,2021-08-06T16:00:02.303
636,2020-08-07T00:00:00.000,Native Hawaiian or Other Pacific Islander,2,97,2021-08-06T16:00:02.303
637,2020-08-08T00:00:00.000,Native Hawaiian or Other Pacific Islander,0,97,2021-08-06T16:00:02.303
638,2020-08-09T00:00:00.000,Native Hawaiian or Other Pacific Islander,0,97,2021-08-06T16:00:02.303
639,2020-08-10T00:00:00.000,Native Hawaiian or Other Pacific Islander,1,98,2021-08-06T16:00:02.303
640,2020-08-11T00:00:00.000,Native Hawaiian or Other Pacific Islander,3,101,2021-08-06T16:00:02.303
641,2020-08-12T00:00:00.000,Native Hawaiian or Other Pacific Islander,5,106,2021-08-06T16:00:02.303
642,2020-08-13T00:00:00.000,Native Hawaiian or Other Pacific Islander,3,109,2021-08-06T16:00:02.303
643,2020-08-14T00:00:00.000,Native Hawaiian or Other Pacific Islander,0,109,2021-08-06T16:00:02.303
644,2020-08-15T00:00:00.000,Native Hawaiian or Other Pacific Islander,1,110,2021-08-06T16:00:02.303
645,2020-08-16T00:00:00.000,Native Hawaiian or Other Pacific Islander,1,111,2021-08-06T16:00:02.303
646,2020-08-17T00:00:00.000,Native Hawaiian or Other Pacific Islander,5,116,2021-08-06T16:00:02.303
647,2020-08-18T00:00:00.000,Native Hawaiian or Other Pacific Islander,2,118,2021-08-06T16:00:02.303
648,2020-08-19T00:00:00.000,Native Hawaiian or Other Pacific Islander,2,120,2021-08-06T16:00:02.303
649,2020-08-20T00:00:00.000,Native Hawaiian or Other Pacific Islander,2,122,2021-08-06T16:00:02.303
650,2020-08-21T00:00:00.000,Native Hawaiian or Other Pacific Islander,7,129,2021-08-06T16:00:02.303
651,2020-08-22T00:00:00.000,Native Hawaiian or Other Pacific Islander,0,129,2021-08-06T16:00:02.303
652,2020-08-23T00:00:00.000,Native Hawaiian or Other Pacific Islander,1,130,2021-08-06T16:00:02.303
653,2020-08-24T00:00:00.000,Native Hawaiian or Other Pacific Islander,0,130,2021-08-06T16:00:02.303
654,2020-08-25T00:00:00.000,Native Hawaiian or Other Pacific Islander,2,132,2021-08-06T16:00:02.303
655,2020-08-26T00:00:00.000,Native Hawaiian or Other Pacific Islander,0,132,2021-08-06T16:00:02.303
656,2020-08-27T00:00:00.000,Native Hawaiian or Other Pacific Islander,0,132,2021-08-06T16:00:02.303
657,2020-08-28T00:00:00.000,Native Hawaiian or Other Pacific Islander,0,132,2021-08-06T16:00:02.303
658,2020-08-29T00:00:00.000,Native Hawaiian or Other Pacific Islander,2,134,2021-08-06T16:00:02.303
659,2020-08-30T00:00:00.000,Native Hawaiian or Other Pacific Islander,1,135,2021-08-06T16:00:02.303
660,2020-08-31T00:00:00.000,Native Hawaiian or Other Pacific Islander,1,136,2021-08-06T16:00:02.303
661,2020-09-01T00:00:00.000,Native Hawaiian or Other Pacific Islander,2,138,2021-08-06T16:00:02.303
662,2020-09-02T00:00:00.000,Native Hawaiian or Other Pacific Islander,2,140,2021-08-06T16:00:02.303
663,2020-09-03T00:00:00.000,Native Hawaiian or Other Pacific Islander,2,142,2021-08-06T16:00:02.303
664,2020-09-04T00:00:00.000,Native Hawaiian or Other Pacific Islander,0,142,2021-08-06T16:00:02.303
665,2020-09-05T00:00:00.000,Native Hawaiian or Other Pacific Islander,0,142,2021-08-06T16:00:02.303
666,2020-09-06T00:00:00.000,Native Hawaiian or Other Pacific Islander,1,143,2021-08-06T16:00:02.303
667,2020-09-07T00:00:00.000,Native Hawaiian or Other Pacific Islander,1,144,2021-08-06T16:00:02.303
668,2020-09-08T00:00:00.000,Native Hawaiian or Other Pacific Islander,1,145,2021-08-06T16:00:02.303
669,2020-09-09T00:00:00.000,Native Hawaiian or Other Pacific Islander,2,147,2021-08-06T16:00:02.303
670,2020-09-10T00:00:00.000,Native Hawaiian or Other Pacific Islander,1,148,2021-08-06T16:00:02.303
671,2020-09-11T00:00:00.000,Native Hawaiian or Other Pacific Islander,0,148,2021-08-06T16:00:02.303
672,2020-09-12T00:00:00.000,Native Hawaiian or Other Pacific Islander,0,148,2021-08-06T16:00:02.303
673,2020-09-13T00:00:00.000,Native Hawaiian or Other Pacific Islander,0,148,2021-08-06T16:00:02.303
674,2020-09-14T00:00:00.000,Native Hawaiian or Other Pacific Islander,0,148,2021-08-06T16:00:02.303
675,2020-09-15T00:00:00.000,Native Hawaiian or Other Pacific Islander,1,149,2021-08-06T16:00:02.303
676,2020-09-16T00:00:00.000,Native Hawaiian or Other Pacific Islander,1,150,2021-08-06T16:00:02.303
677,2020-09-17T00:00:00.000,Native Hawaiian or Other Pacific Islander,1,151,2021-08-06T16:00:02.303
678,2020-09-18T00:00:00.000,Native Hawaiian or Other Pacific Islander,0,151,2021-08-06T16:00:02.303
679,2020-09-19T00:00:00.000,Native Hawaiian or Other Pacific Islander,0,151,2021-08-06T16:00:02.303
680,2020-09-20T00:00:00.000,Native Hawaiian or Other Pacific Islander,0,151,2021-08-06T16:00:02.303
681,2020-09-21T00:00:00.000,Native Hawaiian or Other Pacific Islander,2,153,2021-08-06T16:00:02.303
682,2020-09-22T00:00:00.000,Native Hawaiian or Other Pacific Islander,0,153,2021-08-06T16:00:02.303
683,2020-09-23T00:00:00.000,Native Hawaiian or Other Pacific Islander,0,153,2021-08-06T16:00:02.303
684,2020-09-24T00:00:00.000,Native Hawaiian or Other Pacific Islander,1,154,2021-08-06T16:00:02.303
685,2020-09-25T00:00:00.000,Native Hawaiian or Other Pacific Islander,0,154,2021-08-06T16:00:02.303
686,2020-09-26T00:00:00.000,Native Hawaiian or Other Pacific Islander,0,154,2021-08-06T16:00:02.303
687,2020-09-27T00:00:00.000,Native Hawaiian or Other Pacific Islander,0,154,2021-08-06T16:00:02.303
688,2020-09-28T00:00:00.000,Native Hawaiian or Other Pacific Islander,1,155,2021-08-06T16:00:02.303
689,2020-09-29T00:00:00.000,Native Hawaiian or Other Pacific Islander,0,155,2021-08-06T16:00:02.303
690,2020-09-30T00:00:00.000,Native Hawaiian or Other Pacific Islander,1,156,2021-08-06T16:00:02.303
691,2020-10-01T00:00:00.000,Native Hawaiian or Other Pacific Islander,0,156,2021-08-06T16:00:02.303
692,2020-10-02T00:00:00.000,Native Hawaiian or Other Pacific Islander,0,156,2021-08-06T16:00:02.303
693,2020-10-03T00:00:00.000,Native Hawaiian or Other Pacific Islander,0,156,2021-08-06T16:00:02.303
694,2020-10-04T00:00:00.000,Native Hawaiian or Other Pacific Islander,0,156,2021-08-06T16:00:02.303
695,2020-10-05T00:00:00.000,Native Hawaiian or Other Pacific Islander,0,156,2021-08-06T16:00:02.303
696,2020-10-06T00:00:00.000,Native Hawaiian or Other Pacific Islander,1,157,2021-08-06T16:00:02.303
697,2020-10-07T00:00:00.000,Native Hawaiian or Other Pacific Islander,1,158,2021-08-06T16:00:02.303
698,2020-10-08T00:00:00.000,Native Hawaiian or Other Pacific Islander,1,159,2021-08-06T16:00:02.303
699,2020-10-09T00:00:00.000,Native Hawaiian or Other Pacific Islander,1,160,2021-08-06T16:00:02.303
700,2020-10-10T00:00:00.000,Native Hawaiian or Other Pacific Islander,1,161,2021-08-06T16:00:02.303
701,2020-10-11T00:00:00.000,Native Hawaiian or Other Pacific Islander,0,161,2021-08-06T16:00:02.303
702,2020-10-12T00:00:00.000,Native Hawaiian or Other Pacific Islander,0,161,2021-08-06T16:00:02.303
703,2020-10-13T00:00:00.000,Native Hawaiian or Other Pacific Islander,1,162,2021-08-06T16:00:02.303
704,2020-10-14T00:00:00.000,Native Hawaiian or Other Pacific Islander,1,163,2021-08-06T16:00:02.303
705,2020-10-15T00:00:00.000,Native Hawaiian or Other Pacific Islander,1,164,2021-08-06T16:00:02.303
706,2020-10-16T00:00:00.000,Native Hawaiian or Other Pacific Islander,0,164,2021-08-06T16:00:02.303
707,2020-10-17T00:00:00.000,Native Hawaiian or Other Pacific Islander,0,164,2021-08-06T16:00:02.303
708,2020-10-18T00:00:00.000,Native Hawaiian or Other Pacific Islander,0,164,2021-08-06T16:00:02.303
709,2020-10-19T00:00:00.000,Native Hawaiian or Other Pacific Islander,1,165,2021-08-06T16:00:02.303
710,2020-10-20T00:00:00.000,Native Hawaiian or Other Pacific Islander,1,166,2021-08-06T16:00:02.303
711,2020-10-21T00:00:00.000,Native Hawaiian or Other Pacific Islander,0,166,2021-08-06T16:00:02.303
712,2020-10-22T00:00:00.000,Native Hawaiian or Other Pacific Islander,0,166,2021-08-06T16:00:02.303
713,2020-10-23T00:00:00.000,Native Hawaiian or Other Pacific Islander,0,166,2021-08-06T16:00:02.303
714,2020-10-24T00:00:00.000,Native Hawaiian or Other Pacific Islander,0,166,2021-08-06T16:00:02.303
715,2020-10-25T00:00:00.000,Native Hawaiian or Other Pacific Islander,0,166,2021-08-06T16:00:02.303
716,2020-10-26T00:00:00.000,Native Hawaiian or Other Pacific Islander,0,166,2021-08-06T16:00:02.303
717,2020-10-27T00:00:00.000,Native Hawaiian or Other Pacific Islander,0,166,2021-08-06T16:00:02.303
718,2020-10-28T00:00:00.000,Native Hawaiian or Other Pacific Islander,0,166,2021-08-06T16:00:02.303
719,2020-10-29T00:00:00.000,Native Hawaiian or Other Pacific Islander,0,166,2021-08-06T16:00:02.303
720,2020-10-30T00:00:00.000,Native Hawaiian or Other Pacific Islander,4,170,2021-08-06T16:00:02.303
721,2020-10-31T00:00:00.000,Native Hawaiian or Other Pacific Islander,1,171,2021-08-06T16:00:02.303
722,2020-11-01T00:00:00.000,Native Hawaiian or Other Pacific Islander,0,171,2021-08-06T16:00:02.303
723,2020-11-02T00:00:00.000,Native Hawaiian or Other Pacific Islander,0,171,2021-08-06T16:00:02.303
724,2020-11-03T00:00:00.000,Native Hawaiian or Other Pacific Islander,3,174,2021-08-06T16:00:02.303
725,2020-11-04T00:00:00.000,Native Hawaiian or Other Pacific Islander,2,176,2021-08-06T16:00:02.303
726,2020-11-05T00:00:00.000,Native Hawaiian or Other Pacific Islander,0,176,2021-08-06T16:00:02.303
727,2020-11-06T00:00:00.000,Native Hawaiian or Other Pacific Islander,0,176,2021-08-06T16:00:02.303
728,2020-11-07T00:00:00.000,Native Hawaiian or Other Pacific Islander,1,177,2021-08-06T16:00:02.303
729,2020-11-08T00:00:00.000,Native Hawaiian or Other Pacific Islander,0,177,2021-08-06T16:00:02.303
730,2020-11-09T00:00:00.000,Native Hawaiian or Other Pacific Islander,1,178,2021-08-06T16:00:02.303
731,2020-11-10T00:00:00.000,Native Hawaiian or Other Pacific Islander,2,180,2021-08-06T16:00:02.303
732,2020-11-11T00:00:00.000,Native Hawaiian or Other Pacific Islander,0,180,2021-08-06T16:00:02.303
733,2020-11-12T00:00:00.000,Native Hawaiian or Other Pacific Islander,1,181,2021-08-06T16:00:02.303
734,2020-11-13T00:00:00.000,Native Hawaiian or Other Pacific Islander,1,182,2021-08-06T16:00:02.303
735,2020-11-14T00:00:00.000,Native Hawaiian or Other Pacific Islander,1,183,2021-08-06T16:00:02.303
736,2020-11-15T00:00:00.000,Native Hawaiian or Other Pacific Islander,0,183,2021-08-06T16:00:02.303
737,2020-11-16T00:00:00.000,Native Hawaiian or Other Pacific Islander,2,185,2021-08-06T16:00:02.303
738,2020-11-17T00:00:00.000,Native Hawaiian or Other Pacific Islander,0,185,2021-08-06T16:00:02.303
739,2020-11-18T00:00:00.000,Native Hawaiian or Other Pacific Islander,2,187,2021-08-06T16:00:02.303
740,2020-11-19T00:00:00.000,Native Hawaiian or Other Pacific Islander,3,190,2021-08-06T16:00:02.303
741,2020-11-20T00:00:00.000,Native Hawaiian or Other Pacific Islander,4,194,2021-08-06T16:00:02.303
742,2020-11-21T00:00:00.000,Native Hawaiian or Other Pacific Islander,0,194,2021-08-06T16:00:02.303
743,2020-11-22T00:00:00.000,Native Hawaiian or Other Pacific Islander,0,194,2021-08-06T16:00:02.303
744,2020-11-23T00:00:00.000,Native Hawaiian or Other Pacific Islander,2,196,2021-08-06T16:00:02.303
745,2020-11-24T00:00:00.000,Native Hawaiian or Other Pacific Islander,2,198,2021-08-06T16:00:02.303
746,2020-11-25T00:00:00.000,Native Hawaiian or Other Pacific Islander,1,199,2021-08-06T16:00:02.303
747,2020-11-26T00:00:00.000,Native Hawaiian or Other Pacific Islander,1,200,2021-08-06T16:00:02.303
748,2020-11-27T00:00:00.000,Native Hawaiian or Other Pacific Islander,3,203,2021-08-06T16:00:02.303
749,2020-11-28T00:00:00.000,Native Hawaiian or Other Pacific Islander,0,203,2021-08-06T16:00:02.303
750,2020-11-29T00:00:00.000,Native Hawaiian or Other Pacific Islander,0,203,2021-08-06T16:00:02.303
751,2020-11-30T00:00:00.000,Native Hawaiian or Other Pacific Islander,0,203,2021-08-06T16:00:02.303
752,2020-12-01T00:00:00.000,Native Hawaiian or Other Pacific Islander,3,206,2021-08-06T16:00:02.303
753,2020-12-02T00:00:00.000,Native Hawaiian or Other Pacific Islander,2,208,2021-08-06T16:00:02.303
754,2020-12-03T00:00:00.000,Native Hawaiian or Other Pacific Islander,1,209,2021-08-06T16:00:02.303
755,2020-12-04T00:00:00.000,Native Hawaiian or Other Pacific Islander,3,212,2021-08-06T16:00:02.303
756,2020-12-05T00:00:00.000,Native Hawaiian or Other Pacific Islander,3,215,2021-08-06T16:00:02.303
757,2020-12-06T00:00:00.000,Native Hawaiian or Other Pacific Islander,0,215,2021-08-06T16:00:02.303
758,2020-12-07T00:00:00.000,Native Hawaiian or Other Pacific Islander,3,218,2021-08-06T16:00:02.303
759,2020-12-08T00:00:00.000,Native Hawaiian or Other Pacific Islander,3,221,2021-08-06T16:00:02.303
760,2020-12-09T00:00:00.000,Native Hawaiian or Other Pacific Islander,4,225,2021-08-06T16:00:02.303
761,2020-12-10T00:00:00.000,Native Hawaiian or Other Pacific Islander,4,229,2021-08-06T16:00:02.303
762,2020-12-11T00:00:00.000,Native Hawaiian or Other Pacific Islander,4,233,2021-08-06T16:00:02.303
763,2020-12-12T00:00:00.000,Native Hawaiian or Other Pacific Islander,1,234,2021-08-06T16:00:02.303
764,2020-12-13T00:00:00.000,Native Hawaiian or Other Pacific Islander,1,235,2021-08-06T16:00:02.303
765,2020-12-14T00:00:00.000,Native Hawaiian or Other Pacific Islander,6,241,2021-08-06T16:00:02.303
766,2020-12-15T00:00:00.000,Native Hawaiian or Other Pacific Islander,2,243,2021-08-06T16:00:02.303
767,2020-12-16T00:00:00.000,Native Hawaiian or Other Pacific Islander,4,247,2021-08-06T16:00:02.303
768,2020-12-17T00:00:00.000,Native Hawaiian or Other Pacific Islander,3,250,2021-08-06T16:00:02.303
769,2020-12-18T00:00:00.000,Native Hawaiian or Other Pacific Islander,1,251,2021-08-06T16:00:02.303
770,2020-12-19T00:00:00.000,Native Hawaiian or Other Pacific Islander,0,251,2021-08-06T16:00:02.303
771,2020-12-20T00:00:00.000,Native Hawaiian or Other Pacific Islander,1,252,2021-08-06T16:00:02.303
772,2020-12-21T00:00:00.000,Native Hawaiian or Other Pacific Islander,2,254,2021-08-06T16:00:02.303
773,2020-12-22T00:00:00.000,Native Hawaiian or Other Pacific Islander,1,255,2021-08-06T16:00:02.303
774,2020-12-23T00:00:00.000,Native Hawaiian or Other Pacific Islander,1,256,2021-08-06T16:00:02.303
775,2020-12-24T00:00:00.000,Native Hawaiian or Other Pacific Islander,2,258,2021-08-06T16:00:02.303
776,2020-12-25T00:00:00.000,Native Hawaiian or Other Pacific Islander,1,259,2021-08-06T16:00:02.303
777,2020-12-26T00:00:00.000,Native Hawaiian or Other Pacific Islander,3,262,2021-08-06T16:00:02.303
778,2020-12-27T00:00:00.000,Native Hawaiian or Other Pacific Islander,2,264,2021-08-06T16:00:02.303
779,2020-12-28T00:00:00.000,Native Hawaiian or Other Pacific Islander,4,268,2021-08-06T16:00:02.303
780,2020-12-29T00:00:00.000,Native Hawaiian or Other Pacific Islander,3,271,2021-08-06T16:00:02.303
781,2020-12-30T00:00:00.000,Native Hawaiian or Other Pacific Islander,6,277,2021-08-06T16:00:02.303
782,2020-12-31T00:00:00.000,Native Hawaiian or Other Pacific Islander,4,281,2021-08-06T16:00:02.303
783,2021-01-01T00:00:00.000,Native Hawaiian or Other Pacific Islander,0,281,2021-08-06T16:00:02.303
784,2021-01-02T00:00:00.000,Native Hawaiian or Other Pacific Islander,5,286,2021-08-06T16:00:02.303
785,2021-01-03T00:00:00.000,Native Hawaiian or Other Pacific Islander,0,286,2021-08-06T16:00:02.303
786,2021-01-04T00:00:00.000,Native Hawaiian or Other Pacific Islander,4,290,2021-08-06T16:00:02.303
787,2021-01-05T00:00:00.000,Native Hawaiian or Other Pacific Islander,8,298,2021-08-06T16:00:02.303
788,2021-01-06T00:00:00.000,Native Hawaiian or Other Pacific Islander,5,303,2021-08-06T16:00:02.303
789,2021-01-07T00:00:00.000,Native Hawaiian or Other Pacific Islander,16,319,2021-08-06T16:00:02.303
790,2021-01-08T00:00:00.000,Native Hawaiian or Other Pacific Islander,10,329,2021-08-06T16:00:02.303
791,2021-01-09T00:00:00.000,Native Hawaiian or Other Pacific Islander,5,334,2021-08-06T16:00:02.303
792,2021-01-10T00:00:00.000,Native Hawaiian or Other Pacific Islander,1,335,2021-08-06T16:00:02.303
793,2021-01-11T00:00:00.000,Native Hawaiian or Other Pacific Islander,9,344,2021-08-06T16:00:02.303
794,2021-01-12T00:00:00.000,Native Hawaiian or Other Pacific Islander,2,346,2021-08-06T16:00:02.303
795,2021-01-13T00:00:00.000,Native Hawaiian or Other Pacific Islander,1,347,2021-08-06T16:00:02.303
796,2021-01-14T00:00:00.000,Native Hawaiian or Other Pacific Islander,8,355,2021-08-06T16:00:02.303
797,2021-01-15T00:00:00.000,Native Hawaiian or Other Pacific Islander,3,358,2021-08-06T16:00:02.303
798,2021-01-16T00:00:00.000,Native Hawaiian or Other Pacific Islander,3,361,2021-08-06T16:00:02.303
799,2021-01-17T00:00:00.000,Native Hawaiian or Other Pacific Islander,1,362,2021-08-06T16:00:02.303
800,2021-01-18T00:00:00.000,Native Hawaiian or Other Pacific Islander,0,362,2021-08-06T16:00:02.303
801,2021-01-19T00:00:00.000,Native Hawaiian or Other Pacific Islander,4,366,2021-08-06T16:00:02.303
802,2021-01-20T00:00:00.000,Native Hawaiian or Other Pacific Islander,5,371,2021-08-06T16:00:02.303
803,2021-01-21T00:00:00.000,Native Hawaiian or Other Pacific Islander,3,374,2021-08-06T16:00:02.303
804,2021-01-22T00:00:00.000,Native Hawaiian or Other Pacific Islander,2,376,2021-08-06T16:00:02.303
805,2021-01-23T00:00:00.000,Native Hawaiian or Other Pacific Islander,0,376,2021-08-06T16:00:02.303
806,2021-01-24T00:00:00.000,Native Hawaiian or Other Pacific Islander,0,376,2021-08-06T16:00:02.303
807,2021-01-25T00:00:00.000,Native Hawaiian or Other Pacific Islander,1,377,2021-08-06T16:00:02.303
808,2021-01-26T00:00:00.000,Native Hawaiian or Other Pacific Islander,3,380,2021-08-06T16:00:02.303
809,2021-01-27T00:00:00.000,Native Hawaiian or Other Pacific Islander,1,381,2021-08-06T16:00:02.303
810,2021-01-28T00:00:00.000,Native Hawaiian or Other Pacific Islander,1,382,2021-08-06T16:00:02.303
811,2021-01-29T00:00:00.000,Native Hawaiian or Other Pacific Islander,4,386,2021-08-06T16:00:02.303
812,2021-01-30T00:00:00.000,Native Hawaiian or Other Pacific Islander,1,387,2021-08-06T16:00:02.303
813,2021-01-31T00:00:00.000,Native Hawaiian or Other Pacific Islander,1,388,2021-08-06T16:00:02.303
814,2021-02-01T00:00:00.000,Native Hawaiian or Other Pacific Islander,0,388,2021-08-06T16:00:02.303
815,2021-02-02T00:00:00.000,Native Hawaiian or Other Pacific Islander,1,389,2021-08-06T16:00:02.303
816,2021-02-03T00:00:00.000,Native Hawaiian or Other Pacific Islander,0,389,2021-08-06T16:00:02.303
817,2021-02-04T00:00:00.000,Native Hawaiian or Other Pacific Islander,1,390,2021-08-06T16:00:02.303
818,2021-02-05T00:00:00.000,Native Hawaiian or Other Pacific Islander,0,390,2021-08-06T16:00:02.303
819,2021-02-06T00:00:00.000,Native Hawaiian or Other Pacific Islander,0,390,2021-08-06T16:00:02.303
820,2021-02-07T00:00:00.000,Native Hawaiian or Other Pacific Islander,0,390,2021-08-06T16:00:02.303
821,2021-02-08T00:00:00.000,Native Hawaiian or Other Pacific Islander,0,390,2021-08-06T16:00:02.303
822,2021-02-09T00:00:00.000,Native Hawaiian or Other Pacific Islander,0,390,2021-08-06T16:00:02.303
823,2021-02-10T00:00:00.000,Native Hawaiian or Other Pacific Islander,0,390,2021-08-06T16:00:02.303
824,2021-02-11T00:00:00.000,Native Hawaiian or Other Pacific Islander,1,391,2021-08-06T16:00:02.303
825,2021-02-12T00:00:00.000,Native Hawaiian or Other Pacific Islander,2,393,2021-08-06T16:00:02.303
826,2021-02-13T00:00:00.000,Native Hawaiian or Other Pacific Islander,0,393,2021-08-06T16:00:02.303
827,2021-02-14T00:00:00.000,Native Hawaiian or Other Pacific Islander,2,395,2021-08-06T16:00:02.303
828,2021-02-15T00:00:00.000,Native Hawaiian or Other Pacific Islander,0,395,2021-08-06T16:00:02.303
829,2021-02-16T00:00:00.000,Native Hawaiian or Other Pacific Islander,0,395,2021-08-06T16:00:02.303
830,2021-02-17T00:00:00.000,Native Hawaiian or Other Pacific Islander,0,395,2021-08-06T16:00:02.303
831,2021-02-18T00:00:00.000,Native Hawaiian or Other Pacific Islander,1,396,2021-08-06T16:00:02.303
832,2021-02-19T00:00:00.000,Native Hawaiian or Other Pacific Islander,0,396,2021-08-06T16:00:02.303
833,2021-02-20T00:00:00.000,Native Hawaiian or Other Pacific Islander,0,396,2021-08-06T16:00:02.303
834,2021-02-21T00:00:00.000,Native Hawaiian or Other Pacific Islander,0,396,2021-08-06T16:00:02.303
835,2021-02-22T00:00:00.000,Native Hawaiian or Other Pacific Islander,1,397,2021-08-06T16:00:02.303
836,2021-02-23T00:00:00.000,Native Hawaiian or Other Pacific Islander,0,397,2021-08-06T16:00:02.303
837,2021-02-24T00:00:00.000,Native Hawaiian or Other Pacific Islander,0,397,2021-08-06T16:00:02.303
838,2021-02-25T00:00:00.000,Native Hawaiian or Other Pacific Islander,0,397,2021-08-06T16:00:02.303
839,2021-02-26T00:00:00.000,Native Hawaiian or Other Pacific Islander,0,397,2021-08-06T16:00:02.303
840,2021-02-27T00:00:00.000,Native Hawaiian or Other Pacific Islander,0,397,2021-08-06T16:00:02.303
841,2021-02-28T00:00:00.000,Native Hawaiian or Other Pacific Islander,0,397,2021-08-06T16:00:02.303
842,2021-03-01T00:00:00.000,Native Hawaiian or Other Pacific Islander,0,397,2021-08-06T16:00:02.303
843,2021-03-02T00:00:00.000,Native Hawaiian or Other Pacific Islander,0,397,2021-08-06T16:00:02.303
844,2021-03-03T00:00:00.000,Native Hawaiian or Other Pacific Islander,0,397,2021-08-06T16:00:02.303
845,2021-03-04T00:00:00.000,Native Hawaiian or Other Pacific Islander,0,397,2021-08-06T16:00:02.303
846,2021-03-05T00:00:00.000,Native Hawaiian or Other Pacific Islander,1,398,2021-08-06T16:00:02.303
847,2021-03-06T00:00:00.000,Native Hawaiian or Other Pacific Islander,0,398,2021-08-06T16:00:02.303
848,2021-03-07T00:00:00.000,Native Hawaiian or Other Pacific Islander,0,398,2021-08-06T16:00:02.303
849,2021-03-08T00:00:00.000,Native Hawaiian or Other Pacific Islander,1,399,2021-08-06T16:00:02.303
850,2021-03-09T00:00:00.000,Native Hawaiian or Other Pacific Islander,1,400,2021-08-06T16:00:02.303
851,2021-03-10T00:00:00.000,Native Hawaiian or Other Pacific Islander,0,400,2021-08-06T16:00:02.303
852,2021-03-11T00:00:00.000,Native Hawaiian or Other Pacific Islander,0,400,2021-08-06T16:00:02.303
853,2021-03-12T00:00:00.000,Native Hawaiian or Other Pacific Islander,0,400,2021-08-06T16:00:02.303
854,2021-03-13T00:00:00.000,Native Hawaiian or Other Pacific Islander,2,402,2021-08-06T16:00:02.303
855,2021-03-14T00:00:00.000,Native Hawaiian or Other Pacific Islander,0,402,2021-08-06T16:00:02.303
856,2021-03-15T00:00:00.000,Native Hawaiian or Other Pacific Islander,3,405,2021-08-06T16:00:02.303
857,2021-03-16T00:00:00.000,Native Hawaiian or Other Pacific Islander,0,405,2021-08-06T16:00:02.303
858,2021-03-17T00:00:00.000,Native Hawaiian or Other Pacific Islander,1,406,2021-08-06T16:00:02.303
859,2021-03-18T00:00:00.000,Native Hawaiian or Other Pacific Islander,0,406,2021-08-06T16:00:02.303
860,2021-03-19T00:00:00.000,Native Hawaiian or Other Pacific Islander,1,407,2021-08-06T16:00:02.303
861,2021-03-20T00:00:00.000,Native Hawaiian or Other Pacific Islander,0,407,2021-08-06T16:00:02.303
862,2021-03-21T00:00:00.000,Native Hawaiian or Other Pacific Islander,1,408,2021-08-06T16:00:02.303
863,2021-03-22T00:00:00.000,Native Hawaiian or Other Pacific Islander,0,408,2021-08-06T16:00:02.303
864,2021-03-23T00:00:00.000,Native Hawaiian or Other Pacific Islander,1,409,2021-08-06T16:00:02.303
865,2021-03-24T00:00:00.000,Native Hawaiian or Other Pacific Islander,2,411,2021-08-06T16:00:02.303
866,2021-03-25T00:00:00.000,Native Hawaiian or Other Pacific Islander,0,411,2021-08-06T16:00:02.303
867,2021-03-26T00:00:00.000,Native Hawaiian or Other Pacific Islander,2,413,2021-08-06T16:00:02.303
868,2021-03-27T00:00:00.000,Native Hawaiian or Other Pacific Islander,0,413,2021-08-06T16:00:02.303
869,2021-03-28T00:00:00.000,Native Hawaiian or Other Pacific Islander,0,413,2021-08-06T16:00:02.303
870,2021-03-29T00:00:00.000,Native Hawaiian or Other Pacific Islander,0,413,2021-08-06T16:00:02.303
871,2021-03-30T00:00:00.000,Native Hawaiian or Other Pacific Islander,1,414,2021-08-06T16:00:02.303
872,2021-03-31T00:00:00.000,Native Hawaiian or Other Pacific Islander,0,414,2021-08-06T16:00:02.303
873,2021-04-01T00:00:00.000,Native Hawaiian or Other Pacific Islander,3,417,2021-08-06T16:00:02.303
874,2021-04-02T00:00:00.000,Native Hawaiian or Other Pacific Islander,4,421,2021-08-06T16:00:02.303
875,2021-04-03T00:00:00.000,Native Hawaiian or Other Pacific Islander,3,424,2021-08-06T16:00:02.303
876,2021-04-04T00:00:00.000,Native Hawaiian or Other Pacific Islander,0,424,2021-08-06T16:00:02.303
877,2021-04-05T00:00:00.000,Native Hawaiian or Other Pacific Islander,1,425,2021-08-06T16:00:02.303
878,2021-04-06T00:00:00.000,Native Hawaiian or Other Pacific Islander,0,425,2021-08-06T16:00:02.303
879,2021-04-07T00:00:00.000,Native Hawaiian or Other Pacific Islander,2,427,2021-08-06T16:00:02.303
880,2021-04-08T00:00:00.000,Native Hawaiian or Other Pacific Islander,0,427,2021-08-06T16:00:02.303
881,2021-04-09T00:00:00.000,Native Hawaiian or Other Pacific Islander,0,427,2021-08-06T16:00:02.303
882,2021-04-10T00:00:00.000,Native Hawaiian or Other Pacific Islander,1,428,2021-08-06T16:00:02.303
883,2021-04-11T00:00:00.000,Native Hawaiian or Other Pacific Islander,0,428,2021-08-06T16:00:02.303
884,2021-04-12T00:00:00.000,Native Hawaiian or Other Pacific Islander,1,429,2021-08-06T16:00:02.303
885,2021-04-13T00:00:00.000,Native Hawaiian or Other Pacific Islander,0,429,2021-08-06T16:00:02.303
886,2021-04-14T00:00:00.000,Native Hawaiian or Other Pacific Islander,0,429,2021-08-06T16:00:02.303
887,2021-04-15T00:00:00.000,Native Hawaiian or Other Pacific Islander,0,429,2021-08-06T16:00:02.303
888,2021-04-16T00:00:00.000,Native Hawaiian or Other Pacific Islander,1,430,2021-08-06T16:00:02.303
889,2021-04-17T00:00:00.000,Native Hawaiian or Other Pacific Islander,0,430,2021-08-06T16:00:02.303
890,2021-04-18T00:00:00.000,Native Hawaiian or Other Pacific Islander,1,431,2021-08-06T16:00:02.303
891,2021-04-19T00:00:00.000,Native Hawaiian or Other Pacific Islander,0,431,2021-08-06T16:00:02.303
892,2021-04-20T00:00:00.000,Native Hawaiian or Other Pacific Islander,0,431,2021-08-06T16:00:02.303
893,2021-04-21T00:00:00.000,Native Hawaiian or Other Pacific Islander,0,431,2021-08-06T16:00:02.303
894,2021-04-22T00:00:00.000,Native Hawaiian or Other Pacific Islander,1,432,2021-08-06T16:00:02.303
895,2021-04-23T00:00:00.000,Native Hawaiian or Other Pacific Islander,0,432,2021-08-06T16:00:02.303
896,2021-04-24T00:00:00.000,Native Hawaiian or Other Pacific Islander,0,432,2021-08-06T16:00:02.303
897,2021-04-25T00:00:00.000,Native Hawaiian or Other Pacific Islander,0,432,2021-08-06T16:00:02.303
898,2021-04-26T00:00:00.000,Native Hawaiian or Other Pacific Islander,5,437,2021-08-06T16:00:02.303
899,2021-04-27T00:00:00.000,Native Hawaiian or Other Pacific Islander,0,437,2021-08-06T16:00:02.303
900,2021-04-28T00:00:00.000,Native Hawaiian or Other Pacific Islander,1,438,2021-08-06T16:00:02.303
901,2021-04-29T00:00:00.000,Native Hawaiian or Other Pacific Islander,0,438,2021-08-06T16:00:02.303
902,2021-04-30T00:00:00.000,Native Hawaiian or Other Pacific Islander,1,439,2021-08-06T16:00:02.303
903,2021-05-01T00:00:00.000,Native Hawaiian or Other Pacific Islander,0,439,2021-08-06T16:00:02.303
904,2021-05-02T00:00:00.000,Native Hawaiian or Other Pacific Islander,0,439,2021-08-06T16:00:02.303
905,2021-05-03T00:00:00.000,Native Hawaiian or Other Pacific Islander,0,439,2021-08-06T16:00:02.303
906,2021-05-04T00:00:00.000,Native Hawaiian or Other Pacific Islander,1,440,2021-08-06T16:00:02.303
907,2021-05-05T00:00:00.000,Native Hawaiian or Other Pacific Islander,1,441,2021-08-06T16:00:02.303
908,2021-05-06T00:00:00.000,Native Hawaiian or Other Pacific Islander,0,441,2021-08-06T16:00:02.303
909,2021-05-07T00:00:00.000,Native Hawaiian or Other Pacific Islander,1,442,2021-08-06T16:00:02.303
910,2021-05-08T00:00:00.000,Native Hawaiian or Other Pacific Islander,0,442,2021-08-06T16:00:02.303
911,2021-05-09T00:00:00.000,Native Hawaiian or Other Pacific Islander,1,443,2021-08-06T16:00:02.303
912,2021-05-10T00:00:00.000,Native Hawaiian or Other Pacific Islander,0,443,2021-08-06T16:00:02.303
913,2021-05-11T00:00:00.000,Native Hawaiian or Other Pacific Islander,0,443,2021-08-06T16:00:02.303
914,2021-05-12T00:00:00.000,Native Hawaiian or Other Pacific Islander,0,443,2021-08-06T16:00:02.303
915,2021-05-13T00:00:00.000,Native Hawaiian or Other Pacific Islander,1,444,2021-08-06T16:00:02.303
916,2021-05-14T00:00:00.000,Native Hawaiian or Other Pacific Islander,0,444,2021-08-06T16:00:02.303
917,2021-05-15T00:00:00.000,Native Hawaiian or Other Pacific Islander,0,444,2021-08-06T16:00:02.303
918,2021-05-16T00:00:00.000,Native Hawaiian or Other Pacific Islander,0,444,2021-08-06T16:00:02.303
919,2021-05-17T00:00:00.000,Native Hawaiian or Other Pacific Islander,1,445,2021-08-06T16:00:02.303
920,2021-05-18T00:00:00.000,Native Hawaiian or Other Pacific Islander,2,447,2021-08-06T16:00:02.303
921,2021-05-19T00:00:00.000,Native Hawaiian or Other Pacific Islander,2,449,2021-08-06T16:00:02.303
922,2021-05-20T00:00:00.000,Native Hawaiian or Other Pacific Islander,1,450,2021-08-06T16:00:02.303
923,2021-05-21T00:00:00.000,Native Hawaiian or Other Pacific Islander,0,450,2021-08-06T16:00:02.303
924,2021-05-22T00:00:00.000,Native Hawaiian or Other Pacific Islander,0,450,2021-08-06T16:00:02.303
925,2021-05-23T00:00:00.000,Native Hawaiian or Other Pacific Islander,0,450,2021-08-06T16:00:02.303
926,2021-05-24T00:00:00.000,Native Hawaiian or Other Pacific Islander,0,450,2021-08-06T16:00:02.303
927,2021-05-25T00:00:00.000,Native Hawaiian or Other Pacific Islander,2,452,2021-08-06T16:00:02.303
928,2021-05-26T00:00:00.000,Native Hawaiian or Other Pacific Islander,0,452,2021-08-06T16:00:02.303
929,2021-05-27T00:00:00.000,Native Hawaiian or Other Pacific Islander,1,453,2021-08-06T16:00:02.303
930,2021-05-28T00:00:00.000,Native Hawaiian or Other Pacific Islander,0,453,2021-08-06T16:00:02.303
931,2021-05-29T00:00:00.000,Native Hawaiian or Other Pacific Islander,0,453,2021-08-06T16:00:02.303
932,2021-05-30T00:00:00.000,Native Hawaiian or Other Pacific Islander,0,453,2021-08-06T16:00:02.303
933,2021-05-31T00:00:00.000,Native Hawaiian or Other Pacific Islander,0,453,2021-08-06T16:00:02.303
934,2021-06-01T00:00:00.000,Native Hawaiian or Other Pacific Islander,1,454,2021-08-06T16:00:02.303
935,2021-06-02T00:00:00.000,Native Hawaiian or Other Pacific Islander,0,454,2021-08-06T16:00:02.303
936,2021-06-03T00:00:00.000,Native Hawaiian or Other Pacific Islander,1,455,2021-08-06T16:00:02.303
937,2021-06-04T00:00:00.000,Native Hawaiian or Other Pacific Islander,3,458,2021-08-06T16:00:02.303
938,2021-06-05T00:00:00.000,Native Hawaiian or Other Pacific Islander,1,459,2021-08-06T16:00:02.303
939,2021-06-06T00:00:00.000,Native Hawaiian or Other Pacific Islander,0,459,2021-08-06T16:00:02.303
940,2021-06-07T00:00:00.000,Native Hawaiian or Other Pacific Islander,1,460,2021-08-06T16:00:02.303
941,2021-06-08T00:00:00.000,Native Hawaiian or Other Pacific Islander,0,460,2021-08-06T16:00:02.303
942,2021-06-09T00:00:00.000,Native Hawaiian or Other Pacific Islander,0,460,2021-08-06T16:00:02.303
943,2021-06-10T00:00:00.000,Native Hawaiian or Other Pacific Islander,0,460,2021-08-06T16:00:02.303
944,2021-06-11T00:00:00.000,Native Hawaiian or Other Pacific Islander,0,460,2021-08-06T16:00:02.303
945,2021-06-12T00:00:00.000,Native Hawaiian or Other Pacific Islander,0,460,2021-08-06T16:00:02.303
946,2021-06-13T00:00:00.000,Native Hawaiian or Other Pacific Islander,0,460,2021-08-06T16:00:02.303
947,2021-06-14T00:00:00.000,Native Hawaiian or Other Pacific Islander,0,460,2021-08-06T16:00:02.303
948,2021-06-15T00:00:00.000,Native Hawaiian or Other Pacific Islander,1,461,2021-08-06T16:00:02.303
949,2021-06-16T00:00:00.000,Native Hawaiian or Other Pacific Islander,0,461,2021-08-06T16:00:02.303
950,2021-06-17T00:00:00.000,Native Hawaiian or Other Pacific Islander,1,462,2021-08-06T16:00:02.303
951,2021-06-18T00:00:00.000,Native Hawaiian or Other Pacific Islander,0,462,2021-08-06T16:00:02.303
952,2021-06-19T00:00:00.000,Native Hawaiian or Other Pacific Islander,0,462,2021-08-06T16:00:02.303
953,2021-06-20T00:00:00.000,Native Hawaiian or Other Pacific Islander,0,462,2021-08-06T16:00:02.303
954,2021-06-21T00:00:00.000,Native Hawaiian or Other Pacific Islander,0,462,2021-08-06T16:00:02.303
955,2021-06-22T00:00:00.000,Native Hawaiian or Other Pacific Islander,0,462,2021-08-06T16:00:02.303
956,2021-06-23T00:00:00.000,Native Hawaiian or Other Pacific Islander,0,462,2021-08-06T16:00:02.303
957,2021-06-24T00:00:00.000,Native Hawaiian or Other Pacific Islander,0,462,2021-08-06T16:00:02.303
958,2021-06-25T00:00:00.000,Native Hawaiian or Other Pacific Islander,0,462,2021-08-06T16:00:02.303
959,2021-06-26T00:00:00.000,Native Hawaiian or Other Pacific Islander,0,462,2021-08-06T16:00:02.303
960,2021-06-27T00:00:00.000,Native Hawaiian or Other Pacific Islander,0,462,2021-08-06T16:00:02.303
961,2021-06-28T00:00:00.000,Native Hawaiian or Other Pacific Islander,0,462,2021-08-06T16:00:02.303
962,2021-06-29T00:00:00.000,Native Hawaiian or Other Pacific Islander,1,463,2021-08-06T16:00:02.303
963,2021-06-30T00:00:00.000,Native Hawaiian or Other Pacific Islander,2,465,2021-08-06T16:00:02.303
964,2021-07-01T00:00:00.000,Native Hawaiian or Other Pacific Islander,2,467,2021-08-06T16:00:02.303
965,2021-07-02T00:00:00.000,Native Hawaiian or Other Pacific Islander,0,467,2021-08-06T16:00:02.303
966,2021-07-03T00:00:00.000,Native Hawaiian or Other Pacific Islander,0,467,2021-08-06T16:00:02.303
967,2021-07-04T00:00:00.000,Native Hawaiian or Other Pacific Islander,0,467,2021-08-06T16:00:02.303
968,2021-07-05T00:00:00.000,Native Hawaiian or Other Pacific Islander,0,467,2021-08-06T16:00:02.303
969,2021-07-06T00:00:00.000,Native Hawaiian or Other Pacific Islander,4,471,2021-08-06T16:00:02.303
970,2021-07-07T00:00:00.000,Native Hawaiian or Other Pacific Islander,2,473,2021-08-06T16:00:02.303
971,2021-07-08T00:00:00.000,Native Hawaiian or Other Pacific Islander,0,473,2021-08-06T16:00:02.303
972,2021-07-09T00:00:00.000,Native Hawaiian or Other Pacific Islander,1,474,2021-08-06T16:00:02.303
973,2021-07-10T00:00:00.000,Native Hawaiian or Other Pacific Islander,0,474,2021-08-06T16:00:02.303
974,2021-07-11T00:00:00.000,Native Hawaiian or Other Pacific Islander,0,474,2021-08-06T16:00:02.303
975,2021-07-12T00:00:00.000,Native Hawaiian or Other Pacific Islander,1,475,2021-08-06T16:00:02.303
976,2021-07-13T00:00:00.000,Native Hawaiian or Other Pacific Islander,0,475,2021-08-06T16:00:02.303
977,2021-07-14T00:00:00.000,Native Hawaiian or Other Pacific Islander,0,475,2021-08-06T16:00:02.303
978,2021-07-15T00:00:00.000,Native Hawaiian or Other Pacific Islander,4,479,2021-08-06T16:00:02.303
979,2021-07-16T00:00:00.000,Native Hawaiian or Other Pacific Islander,1,480,2021-08-06T16:00:02.303
980,2021-07-17T00:00:00.000,Native Hawaiian or Other Pacific Islander,0,480,2021-08-06T16:00:02.303
981,2021-07-18T00:00:00.000,Native Hawaiian or Other Pacific Islander,2,482,2021-08-06T16:00:02.303
982,2021-07-19T00:00:00.000,Native Hawaiian or Other Pacific Islander,0,482,2021-08-06T16:00:02.303
983,2021-07-20T00:00:00.000,Native Hawaiian or Other Pacific Islander,3,485,2021-08-06T16:00:02.303
984,2021-07-21T00:00:00.000,Native Hawaiian or Other Pacific Islander,2,487,2021-08-06T16:00:02.303
985,2021-07-22T00:00:00.000,Native Hawaiian or Other Pacific Islander,2,489,2021-08-06T16:00:02.303
986,2021-07-23T00:00:00.000,Native Hawaiian or Other Pacific Islander,0,489,2021-08-06T16:00:02.303
987,2021-07-24T00:00:00.000,Native Hawaiian or Other Pacific Islander,1,490,2021-08-06T16:00:02.303
988,2021-07-25T00:00:00.000,Native Hawaiian or Other Pacific Islander,3,493,2021-08-06T16:00:02.303
989,2021-07-26T00:00:00.000,Native Hawaiian or Other Pacific Islander,1,494,2021-08-06T16:00:02.303
990,2021-07-27T00:00:00.000,Native Hawaiian or Other Pacific Islander,4,498,2021-08-06T16:00:02.303
991,2021-07-28T00:00:00.000,Native Hawaiian or Other Pacific Islander,7,505,2021-08-06T16:00:02.303
992,2021-07-29T00:00:00.000,Native Hawaiian or Other Pacific Islander,7,512,2021-08-06T16:00:02.303
993,2021-07-30T00:00:00.000,Native Hawaiian or Other Pacific Islander,4,516,2021-08-06T16:00:02.303
994,2021-07-31T00:00:00.000,Native Hawaiian or Other Pacific Islander,1,517,2021-08-06T16:00:02.303
995,2021-08-01T00:00:00.000,Native Hawaiian or Other Pacific Islander,0,517,2021-08-06T16:00:02.303
996,2021-08-02T00:00:00.000,Native Hawaiian or Other Pacific Islander,4,521,2021-08-06T16:00:02.303
997,2020-03-13T00:00:00.000,White,3,7,2021-08-06T16:00:02.303
998,2020-03-14T00:00:00.000,White,5,12,2021-08-06T16:00:02.303
999,2020-03-15T00:00:00.000,White,6,18,2021-08-06T16:00:02.303
