,specimen_collection_date,race_ethnicity,new_confirmed_cases,cumulative_confirmed_cases,last_updated_at
0,2020-03-13T00:00:00.000,Asian,3,7,2021-07-21T16:00:01.947
1,2020-03-14T00:00:00.000,Asian,2,9,2021-07-21T16:00:01.947
2,2020-03-15T00:00:00.000,Asian,2,11,2021-07-21T16:00:01.947
3,2020-03-16T00:00:00.000,Asian,8,19,2021-07-21T16:00:01.947
4,2020-03-17T00:00:00.000,Asian,4,23,2021-07-21T16:00:01.947
5,2020-03-18T00:00:00.000,Asian,0,23,2021-07-21T16:00:01.947
6,2020-03-19T00:00:00.000,Asian,3,26,2021-07-21T16:00:01.947
7,2020-03-20T00:00:00.000,Asian,7,33,2021-07-21T16:00:01.947
8,2020-03-21T00:00:00.000,Asian,3,36,2021-07-21T16:00:01.947
9,2020-03-22T00:00:00.000,Asian,3,39,2021-07-21T16:00:01.947
10,2020-03-23T00:00:00.000,Asian,2,41,2021-07-21T16:00:01.947
11,2020-03-24T00:00:00.000,Asian,6,47,2021-07-21T16:00:01.947
12,2020-03-25T00:00:00.000,Asian,9,56,2021-07-21T16:00:01.947
13,2020-03-26T00:00:00.000,Asian,4,60,2021-07-21T16:00:01.947
14,2020-03-27T00:00:00.000,Asian,9,69,2021-07-21T16:00:01.947
15,2020-03-28T00:00:00.000,Asian,2,71,2021-07-21T16:00:01.947
16,2020-03-29T00:00:00.000,Asian,5,76,2021-07-21T16:00:01.947
17,2020-03-30T00:00:00.000,Asian,11,87,2021-07-21T16:00:01.947
18,2020-03-31T00:00:00.000,Asian,11,98,2021-07-21T16:00:01.947
19,2020-04-01T00:00:00.000,Asian,9,107,2021-07-21T16:00:01.947
20,2020-04-02T00:00:00.000,Asian,9,116,2021-07-21T16:00:01.947
21,2020-04-03T00:00:00.000,Asian,6,122,2021-07-21T16:00:01.947
22,2020-04-04T00:00:00.000,Asian,1,123,2021-07-21T16:00:01.947
23,2020-04-05T00:00:00.000,Asian,9,132,2021-07-21T16:00:01.947
24,2020-04-06T00:00:00.000,Asian,5,137,2021-07-21T16:00:01.947
25,2020-04-07T00:00:00.000,Asian,8,145,2021-07-21T16:00:01.947
26,2020-04-08T00:00:00.000,Asian,4,149,2021-07-21T16:00:01.947
27,2020-04-09T00:00:00.000,Asian,6,155,2021-07-21T16:00:01.947
28,2020-04-10T00:00:00.000,Asian,9,164,2021-07-21T16:00:01.947
29,2020-04-11T00:00:00.000,Asian,5,169,2021-07-21T16:00:01.947
30,2020-04-12T00:00:00.000,Asian,3,172,2021-07-21T16:00:01.947
31,2020-04-13T00:00:00.000,Asian,9,181,2021-07-21T16:00:01.947
32,2020-04-14T00:00:00.000,Asian,10,191,2021-07-21T16:00:01.947
33,2020-04-15T00:00:00.000,Asian,8,199,2021-07-21T16:00:01.947
34,2020-04-16T00:00:00.000,Asian,3,202,2021-07-21T16:00:01.947
35,2020-04-17T00:00:00.000,Asian,8,210,2021-07-21T16:00:01.947
36,2020-04-18T00:00:00.000,Asian,0,210,2021-07-21T16:00:01.947
37,2020-04-19T00:00:00.000,Asian,1,211,2021-07-21T16:00:01.947
38,2020-04-20T00:00:00.000,Asian,4,215,2021-07-21T16:00:01.947
39,2020-04-21T00:00:00.000,Asian,6,221,2021-07-21T16:00:01.947
40,2020-04-22T00:00:00.000,Asian,3,224,2021-07-21T16:00:01.947
41,2020-04-23T00:00:00.000,Asian,7,231,2021-07-21T16:00:01.947
42,2020-04-24T00:00:00.000,Asian,4,235,2021-07-21T16:00:01.947
43,2020-04-25T00:00:00.000,Asian,5,240,2021-07-21T16:00:01.947
44,2020-04-26T00:00:00.000,Asian,4,244,2021-07-21T16:00:01.947
45,2020-04-27T00:00:00.000,Asian,2,246,2021-07-21T16:00:01.947
46,2020-04-28T00:00:00.000,Asian,6,252,2021-07-21T16:00:01.947
47,2020-04-29T00:00:00.000,Asian,9,261,2021-07-21T16:00:01.947
48,2020-04-30T00:00:00.000,Asian,6,267,2021-07-21T16:00:01.947
49,2020-05-01T00:00:00.000,Asian,4,271,2021-07-21T16:00:01.947
50,2020-05-02T00:00:00.000,Asian,4,275,2021-07-21T16:00:01.947
51,2020-05-03T00:00:00.000,Asian,1,276,2021-07-21T16:00:01.947
52,2020-05-04T00:00:00.000,Asian,1,277,2021-07-21T16:00:01.947
53,2020-05-05T00:00:00.000,Asian,3,280,2021-07-21T16:00:01.947
54,2020-05-06T00:00:00.000,Asian,4,284,2021-07-21T16:00:01.947
55,2020-05-07T00:00:00.000,Asian,1,285,2021-07-21T16:00:01.947
56,2020-05-08T00:00:00.000,Asian,2,287,2021-07-21T16:00:01.947
57,2020-05-09T00:00:00.000,Asian,1,288,2021-07-21T16:00:01.947
58,2020-05-10T00:00:00.000,Asian,0,288,2021-07-21T16:00:01.947
59,2020-05-11T00:00:00.000,Asian,3,291,2021-07-21T16:00:01.947
60,2020-05-12T00:00:00.000,Asian,12,303,2021-07-21T16:00:01.947
61,2020-05-13T00:00:00.000,Asian,2,305,2021-07-21T16:00:01.947
62,2020-05-14T00:00:00.000,Asian,4,309,2021-07-21T16:00:01.947
63,2020-05-15T00:00:00.000,Asian,4,313,2021-07-21T16:00:01.947
64,2020-05-16T00:00:00.000,Asian,4,317,2021-07-21T16:00:01.947
65,2020-05-17T00:00:00.000,Asian,1,318,2021-07-21T16:00:01.947
66,2020-05-18T00:00:00.000,Asian,4,322,2021-07-21T16:00:01.947
67,2020-05-19T00:00:00.000,Asian,0,322,2021-07-21T16:00:01.947
68,2020-05-20T00:00:00.000,Asian,3,325,2021-07-21T16:00:01.947
69,2020-05-21T00:00:00.000,Asian,8,333,2021-07-21T16:00:01.947
70,2020-05-22T00:00:00.000,Asian,0,333,2021-07-21T16:00:01.947
71,2020-05-23T00:00:00.000,Asian,3,336,2021-07-21T16:00:01.947
72,2020-05-24T00:00:00.000,Asian,1,337,2021-07-21T16:00:01.947
73,2020-05-25T00:00:00.000,Asian,0,337,2021-07-21T16:00:01.947
74,2020-05-26T00:00:00.000,Asian,6,343,2021-07-21T16:00:01.947
75,2020-05-27T00:00:00.000,Asian,5,348,2021-07-21T16:00:01.947
76,2020-05-28T00:00:00.000,Asian,3,351,2021-07-21T16:00:01.947
77,2020-05-29T00:00:00.000,Asian,1,352,2021-07-21T16:00:01.947
78,2020-05-30T00:00:00.000,Asian,3,355,2021-07-21T16:00:01.947
79,2020-05-31T00:00:00.000,Asian,5,360,2021-07-21T16:00:01.947
80,2020-06-01T00:00:00.000,Asian,5,365,2021-07-21T16:00:01.947
81,2020-06-02T00:00:00.000,Asian,4,369,2021-07-21T16:00:01.947
82,2020-06-03T00:00:00.000,Asian,2,371,2021-07-21T16:00:01.947
83,2020-06-04T00:00:00.000,Asian,5,376,2021-07-21T16:00:01.947
84,2020-06-05T00:00:00.000,Asian,2,378,2021-07-21T16:00:01.947
85,2020-06-06T00:00:00.000,Asian,1,379,2021-07-21T16:00:01.947
86,2020-06-07T00:00:00.000,Asian,0,379,2021-07-21T16:00:01.947
87,2020-06-08T00:00:00.000,Asian,5,384,2021-07-21T16:00:01.947
88,2020-06-09T00:00:00.000,Asian,4,388,2021-07-21T16:00:01.947
89,2020-06-10T00:00:00.000,Asian,3,391,2021-07-21T16:00:01.947
90,2020-06-11T00:00:00.000,Asian,2,393,2021-07-21T16:00:01.947
91,2020-06-12T00:00:00.000,Asian,1,394,2021-07-21T16:00:01.947
92,2020-06-13T00:00:00.000,Asian,2,396,2021-07-21T16:00:01.947
93,2020-06-14T00:00:00.000,Asian,1,397,2021-07-21T16:00:01.947
94,2020-06-15T00:00:00.000,Asian,1,398,2021-07-21T16:00:01.947
95,2020-06-16T00:00:00.000,Asian,3,401,2021-07-21T16:00:01.947
96,2020-06-17T00:00:00.000,Asian,2,403,2021-07-21T16:00:01.947
97,2020-06-18T00:00:00.000,Asian,5,408,2021-07-21T16:00:01.947
98,2020-06-19T00:00:00.000,Asian,2,410,2021-07-21T16:00:01.947
99,2020-06-20T00:00:00.000,Asian,7,417,2021-07-21T16:00:01.947
100,2020-06-21T00:00:00.000,Asian,3,420,2021-07-21T16:00:01.947
101,2020-06-22T00:00:00.000,Asian,7,427,2021-07-21T16:00:01.947
102,2020-06-23T00:00:00.000,Asian,11,438,2021-07-21T16:00:01.947
103,2020-06-24T00:00:00.000,Asian,6,444,2021-07-21T16:00:01.947
104,2020-06-25T00:00:00.000,Asian,11,455,2021-07-21T16:00:01.947
105,2020-06-26T00:00:00.000,Asian,6,461,2021-07-21T16:00:01.947
106,2020-06-27T00:00:00.000,Asian,2,463,2021-07-21T16:00:01.947
107,2020-06-28T00:00:00.000,Asian,4,467,2021-07-21T16:00:01.947
108,2020-06-29T00:00:00.000,Asian,11,478,2021-07-21T16:00:01.947
109,2020-06-30T00:00:00.000,Asian,15,493,2021-07-21T16:00:01.947
110,2020-07-01T00:00:00.000,Asian,7,500,2021-07-21T16:00:01.947
111,2020-07-02T00:00:00.000,Asian,7,507,2021-07-21T16:00:01.947
112,2020-07-03T00:00:00.000,Asian,7,514,2021-07-21T16:00:01.947
113,2020-07-04T00:00:00.000,Asian,0,514,2021-07-21T16:00:01.947
114,2020-07-05T00:00:00.000,Asian,6,520,2021-07-21T16:00:01.947
115,2020-07-06T00:00:00.000,Asian,13,533,2021-07-21T16:00:01.947
116,2020-07-07T00:00:00.000,Asian,12,545,2021-07-21T16:00:01.947
117,2020-07-08T00:00:00.000,Asian,6,551,2021-07-21T16:00:01.947
118,2020-07-09T00:00:00.000,Asian,11,562,2021-07-21T16:00:01.947
119,2020-07-10T00:00:00.000,Asian,7,569,2021-07-21T16:00:01.947
120,2020-07-11T00:00:00.000,Asian,5,574,2021-07-21T16:00:01.947
121,2020-07-12T00:00:00.000,Asian,8,582,2021-07-21T16:00:01.947
122,2020-07-13T00:00:00.000,Asian,7,589,2021-07-21T16:00:01.947
123,2020-07-14T00:00:00.000,Asian,16,605,2021-07-21T16:00:01.947
124,2020-07-15T00:00:00.000,Asian,15,620,2021-07-21T16:00:01.947
125,2020-07-16T00:00:00.000,Asian,8,628,2021-07-21T16:00:01.947
126,2020-07-17T00:00:00.000,Asian,8,636,2021-07-21T16:00:01.947
127,2020-07-18T00:00:00.000,Asian,6,642,2021-07-21T16:00:01.947
128,2020-07-19T00:00:00.000,Asian,4,646,2021-07-21T16:00:01.947
129,2020-07-20T00:00:00.000,Asian,11,657,2021-07-21T16:00:01.947
130,2020-07-21T00:00:00.000,Asian,12,669,2021-07-21T16:00:01.947
131,2020-07-22T00:00:00.000,Asian,11,680,2021-07-21T16:00:01.947
132,2020-07-23T00:00:00.000,Asian,12,692,2021-07-21T16:00:01.947
133,2020-07-24T00:00:00.000,Asian,9,701,2021-07-21T16:00:01.947
134,2020-07-25T00:00:00.000,Asian,5,706,2021-07-21T16:00:01.947
135,2020-07-26T00:00:00.000,Asian,5,711,2021-07-21T16:00:01.947
136,2020-07-27T00:00:00.000,Asian,8,719,2021-07-21T16:00:01.947
137,2020-07-28T00:00:00.000,Asian,5,724,2021-07-21T16:00:01.947
138,2020-07-29T00:00:00.000,Asian,15,739,2021-07-21T16:00:01.947
139,2020-07-30T00:00:00.000,Asian,17,756,2021-07-21T16:00:01.947
140,2020-07-31T00:00:00.000,Asian,20,776,2021-07-21T16:00:01.947
141,2020-08-01T00:00:00.000,Asian,11,787,2021-07-21T16:00:01.947
142,2020-08-02T00:00:00.000,Asian,8,795,2021-07-21T16:00:01.947
143,2020-08-03T00:00:00.000,Asian,7,802,2021-07-21T16:00:01.947
144,2020-08-04T00:00:00.000,Asian,8,810,2021-07-21T16:00:01.947
145,2020-08-05T00:00:00.000,Asian,14,824,2021-07-21T16:00:01.947
146,2020-08-06T00:00:00.000,Asian,9,833,2021-07-21T16:00:01.947
147,2020-08-07T00:00:00.000,Asian,11,844,2021-07-21T16:00:01.947
148,2020-08-08T00:00:00.000,Asian,4,848,2021-07-21T16:00:01.947
149,2020-08-09T00:00:00.000,Asian,3,851,2021-07-21T16:00:01.947
150,2020-08-10T00:00:00.000,Asian,12,863,2021-07-21T16:00:01.947
151,2020-08-11T00:00:00.000,Asian,7,870,2021-07-21T16:00:01.947
152,2020-08-12T00:00:00.000,Asian,10,880,2021-07-21T16:00:01.947
153,2020-08-13T00:00:00.000,Asian,8,888,2021-07-21T16:00:01.947
154,2020-08-14T00:00:00.000,Asian,23,911,2021-07-21T16:00:01.947
155,2020-08-15T00:00:00.000,Asian,16,927,2021-07-21T16:00:01.947
156,2020-08-16T00:00:00.000,Asian,8,935,2021-07-21T16:00:01.947
157,2020-08-17T00:00:00.000,Asian,8,943,2021-07-21T16:00:01.947
158,2020-08-18T00:00:00.000,Asian,15,958,2021-07-21T16:00:01.947
159,2020-08-19T00:00:00.000,Asian,12,970,2021-07-21T16:00:01.947
160,2020-08-20T00:00:00.000,Asian,12,982,2021-07-21T16:00:01.947
161,2020-08-21T00:00:00.000,Asian,16,998,2021-07-21T16:00:01.947
162,2020-08-22T00:00:00.000,Asian,10,1008,2021-07-21T16:00:01.947
163,2020-08-23T00:00:00.000,Asian,8,1016,2021-07-21T16:00:01.947
164,2020-08-24T00:00:00.000,Asian,11,1027,2021-07-21T16:00:01.947
165,2020-08-25T00:00:00.000,Asian,10,1037,2021-07-21T16:00:01.947
166,2020-08-26T00:00:00.000,Asian,17,1054,2021-07-21T16:00:01.947
167,2020-08-27T00:00:00.000,Asian,17,1071,2021-07-21T16:00:01.947
168,2020-08-28T00:00:00.000,Asian,9,1080,2021-07-21T16:00:01.947
169,2020-08-29T00:00:00.000,Asian,8,1088,2021-07-21T16:00:01.947
170,2020-08-30T00:00:00.000,Asian,4,1092,2021-07-21T16:00:01.947
171,2020-08-31T00:00:00.000,Asian,17,1109,2021-07-21T16:00:01.947
172,2020-09-01T00:00:00.000,Asian,12,1121,2021-07-21T16:00:01.947
173,2020-09-02T00:00:00.000,Asian,27,1148,2021-07-21T16:00:01.947
174,2020-09-03T00:00:00.000,Asian,18,1166,2021-07-21T16:00:01.947
175,2020-09-04T00:00:00.000,Asian,8,1174,2021-07-21T16:00:01.947
176,2020-09-05T00:00:00.000,Asian,8,1182,2021-07-21T16:00:01.947
177,2020-09-06T00:00:00.000,Asian,6,1188,2021-07-21T16:00:01.947
178,2020-09-07T00:00:00.000,Asian,11,1199,2021-07-21T16:00:01.947
179,2020-09-08T00:00:00.000,Asian,13,1212,2021-07-21T16:00:01.947
180,2020-09-09T00:00:00.000,Asian,23,1235,2021-07-21T16:00:01.947
181,2020-09-10T00:00:00.000,Asian,11,1246,2021-07-21T16:00:01.947
182,2020-09-11T00:00:00.000,Asian,31,1277,2021-07-21T16:00:01.947
183,2020-09-12T00:00:00.000,Asian,8,1285,2021-07-21T16:00:01.947
184,2020-09-13T00:00:00.000,Asian,3,1288,2021-07-21T16:00:01.947
185,2020-09-14T00:00:00.000,Asian,14,1302,2021-07-21T16:00:01.947
186,2020-09-15T00:00:00.000,Asian,17,1319,2021-07-21T16:00:01.947
187,2020-09-16T00:00:00.000,Asian,6,1325,2021-07-21T16:00:01.947
188,2020-09-17T00:00:00.000,Asian,7,1332,2021-07-21T16:00:01.947
189,2020-09-18T00:00:00.000,Asian,12,1344,2021-07-21T16:00:01.947
190,2020-09-19T00:00:00.000,Asian,6,1350,2021-07-21T16:00:01.947
191,2020-09-20T00:00:00.000,Asian,5,1355,2021-07-21T16:00:01.947
192,2020-09-21T00:00:00.000,Asian,6,1361,2021-07-21T16:00:01.947
193,2020-09-22T00:00:00.000,Asian,10,1371,2021-07-21T16:00:01.947
194,2020-09-23T00:00:00.000,Asian,8,1379,2021-07-21T16:00:01.947
195,2020-09-24T00:00:00.000,Asian,11,1390,2021-07-21T16:00:01.947
196,2020-09-25T00:00:00.000,Asian,14,1404,2021-07-21T16:00:01.947
197,2020-09-26T00:00:00.000,Asian,2,1406,2021-07-21T16:00:01.947
198,2020-09-27T00:00:00.000,Asian,4,1410,2021-07-21T16:00:01.947
199,2020-09-28T00:00:00.000,Asian,8,1418,2021-07-21T16:00:01.947
200,2020-09-29T00:00:00.000,Asian,10,1428,2021-07-21T16:00:01.947
201,2020-09-30T00:00:00.000,Asian,13,1441,2021-07-21T16:00:01.947
202,2020-10-01T00:00:00.000,Asian,4,1445,2021-07-21T16:00:01.947
203,2020-10-02T00:00:00.000,Asian,6,1451,2021-07-21T16:00:01.947
204,2020-10-03T00:00:00.000,Asian,4,1455,2021-07-21T16:00:01.947
205,2020-10-04T00:00:00.000,Asian,3,1458,2021-07-21T16:00:01.947
206,2020-10-05T00:00:00.000,Asian,3,1461,2021-07-21T16:00:01.947
207,2020-10-06T00:00:00.000,Asian,6,1467,2021-07-21T16:00:01.947
208,2020-10-07T00:00:00.000,Asian,4,1471,2021-07-21T16:00:01.947
209,2020-10-08T00:00:00.000,Asian,1,1472,2021-07-21T16:00:01.947
210,2020-10-09T00:00:00.000,Asian,5,1477,2021-07-21T16:00:01.947
211,2020-10-10T00:00:00.000,Asian,3,1480,2021-07-21T16:00:01.947
212,2020-10-11T00:00:00.000,Asian,2,1482,2021-07-21T16:00:01.947
213,2020-10-12T00:00:00.000,Asian,4,1486,2021-07-21T16:00:01.947
214,2020-10-13T00:00:00.000,Asian,2,1488,2021-07-21T16:00:01.947
215,2020-10-14T00:00:00.000,Asian,4,1492,2021-07-21T16:00:01.947
216,2020-10-15T00:00:00.000,Asian,4,1496,2021-07-21T16:00:01.947
217,2020-10-16T00:00:00.000,Asian,3,1499,2021-07-21T16:00:01.947
218,2020-10-17T00:00:00.000,Asian,5,1504,2021-07-21T16:00:01.947
219,2020-10-18T00:00:00.000,Asian,0,1504,2021-07-21T16:00:01.947
220,2020-10-19T00:00:00.000,Asian,9,1513,2021-07-21T16:00:01.947
221,2020-10-20T00:00:00.000,Asian,1,1514,2021-07-21T16:00:01.947
222,2020-10-21T00:00:00.000,Asian,3,1517,2021-07-21T16:00:01.947
223,2020-10-22T00:00:00.000,Asian,8,1525,2021-07-21T16:00:01.947
224,2020-10-23T00:00:00.000,Asian,6,1531,2021-07-21T16:00:01.947
225,2020-10-24T00:00:00.000,Asian,4,1535,2021-07-21T16:00:01.947
226,2020-10-25T00:00:00.000,Asian,7,1542,2021-07-21T16:00:01.947
227,2020-10-26T00:00:00.000,Asian,7,1549,2021-07-21T16:00:01.947
228,2020-10-27T00:00:00.000,Asian,9,1558,2021-07-21T16:00:01.947
229,2020-10-28T00:00:00.000,Asian,9,1567,2021-07-21T16:00:01.947
230,2020-10-29T00:00:00.000,Asian,3,1570,2021-07-21T16:00:01.947
231,2020-10-30T00:00:00.000,Asian,6,1576,2021-07-21T16:00:01.947
232,2020-10-31T00:00:00.000,Asian,9,1585,2021-07-21T16:00:01.947
233,2020-11-01T00:00:00.000,Asian,4,1589,2021-07-21T16:00:01.947
234,2020-11-02T00:00:00.000,Asian,15,1604,2021-07-21T16:00:01.947
235,2020-11-03T00:00:00.000,Asian,16,1620,2021-07-21T16:00:01.947
236,2020-11-04T00:00:00.000,Asian,27,1647,2021-07-21T16:00:01.947
237,2020-11-05T00:00:00.000,Asian,14,1661,2021-07-21T16:00:01.947
238,2020-11-06T00:00:00.000,Asian,9,1670,2021-07-21T16:00:01.947
239,2020-11-07T00:00:00.000,Asian,10,1680,2021-07-21T16:00:01.947
240,2020-11-08T00:00:00.000,Asian,2,1682,2021-07-21T16:00:01.947
241,2020-11-09T00:00:00.000,Asian,14,1696,2021-07-21T16:00:01.947
242,2020-11-10T00:00:00.000,Asian,12,1708,2021-07-21T16:00:01.947
243,2020-11-11T00:00:00.000,Asian,14,1722,2021-07-21T16:00:01.947
244,2020-11-12T00:00:00.000,Asian,26,1748,2021-07-21T16:00:01.947
245,2020-11-13T00:00:00.000,Asian,19,1767,2021-07-21T16:00:01.947
246,2020-11-14T00:00:00.000,Asian,13,1780,2021-07-21T16:00:01.947
247,2020-11-15T00:00:00.000,Asian,9,1789,2021-07-21T16:00:01.947
248,2020-11-16T00:00:00.000,Asian,38,1827,2021-07-21T16:00:01.947
249,2020-11-17T00:00:00.000,Asian,24,1851,2021-07-21T16:00:01.947
250,2020-11-18T00:00:00.000,Asian,36,1887,2021-07-21T16:00:01.947
251,2020-11-19T00:00:00.000,Asian,22,1909,2021-07-21T16:00:01.947
252,2020-11-20T00:00:00.000,Asian,16,1925,2021-07-21T16:00:01.947
253,2020-11-21T00:00:00.000,Asian,16,1941,2021-07-21T16:00:01.947
254,2020-11-22T00:00:00.000,Asian,9,1950,2021-07-21T16:00:01.947
255,2020-11-23T00:00:00.000,Asian,25,1975,2021-07-21T16:00:01.947
256,2020-11-24T00:00:00.000,Asian,25,2000,2021-07-21T16:00:01.947
257,2020-11-25T00:00:00.000,Asian,22,2022,2021-07-21T16:00:01.947
258,2020-11-26T00:00:00.000,Asian,19,2041,2021-07-21T16:00:01.947
259,2020-11-27T00:00:00.000,Asian,31,2072,2021-07-21T16:00:01.947
260,2020-11-28T00:00:00.000,Asian,27,2099,2021-07-21T16:00:01.947
261,2020-11-29T00:00:00.000,Asian,18,2117,2021-07-21T16:00:01.947
262,2020-11-30T00:00:00.000,Asian,62,2179,2021-07-21T16:00:01.947
263,2020-12-01T00:00:00.000,Asian,54,2233,2021-07-21T16:00:01.947
264,2020-12-02T00:00:00.000,Asian,58,2291,2021-07-21T16:00:01.947
265,2020-12-03T00:00:00.000,Asian,40,2331,2021-07-21T16:00:01.947
266,2020-12-04T00:00:00.000,Asian,42,2373,2021-07-21T16:00:01.947
267,2020-12-05T00:00:00.000,Asian,36,2409,2021-07-21T16:00:01.947
268,2020-12-06T00:00:00.000,Asian,27,2436,2021-07-21T16:00:01.947
269,2020-12-07T00:00:00.000,Asian,68,2504,2021-07-21T16:00:01.947
270,2020-12-08T00:00:00.000,Asian,76,2580,2021-07-21T16:00:01.947
271,2020-12-09T00:00:00.000,Asian,67,2647,2021-07-21T16:00:01.947
272,2020-12-10T00:00:00.000,Asian,55,2702,2021-07-21T16:00:01.947
273,2020-12-11T00:00:00.000,Asian,77,2779,2021-07-21T16:00:01.947
274,2020-12-12T00:00:00.000,Asian,42,2821,2021-07-21T16:00:01.947
275,2020-12-13T00:00:00.000,Asian,34,2855,2021-07-21T16:00:01.947
276,2020-12-14T00:00:00.000,Asian,69,2924,2021-07-21T16:00:01.947
277,2020-12-15T00:00:00.000,Asian,99,3023,2021-07-21T16:00:01.947
278,2020-12-16T00:00:00.000,Asian,81,3104,2021-07-21T16:00:01.947
279,2020-12-17T00:00:00.000,Asian,45,3149,2021-07-21T16:00:01.947
280,2020-12-18T00:00:00.000,Asian,53,3202,2021-07-21T16:00:01.947
281,2020-12-19T00:00:00.000,Asian,30,3232,2021-07-21T16:00:01.947
282,2020-12-20T00:00:00.000,Asian,17,3249,2021-07-21T16:00:01.947
283,2020-12-21T00:00:00.000,Asian,58,3307,2021-07-21T16:00:01.947
284,2020-12-22T00:00:00.000,Asian,70,3377,2021-07-21T16:00:01.947
285,2020-12-23T00:00:00.000,Asian,67,3444,2021-07-21T16:00:01.947
286,2020-12-24T00:00:00.000,Asian,45,3489,2021-07-21T16:00:01.947
287,2020-12-25T00:00:00.000,Asian,26,3515,2021-07-21T16:00:01.947
288,2020-12-26T00:00:00.000,Asian,57,3572,2021-07-21T16:00:01.947
289,2020-12-27T00:00:00.000,Asian,37,3609,2021-07-21T16:00:01.947
290,2020-12-28T00:00:00.000,Asian,78,3687,2021-07-21T16:00:01.947
291,2020-12-29T00:00:00.000,Asian,97,3784,2021-07-21T16:00:01.947
292,2020-12-30T00:00:00.000,Asian,107,3891,2021-07-21T16:00:01.947
293,2020-12-31T00:00:00.000,Asian,43,3934,2021-07-21T16:00:01.947
294,2021-01-01T00:00:00.000,Asian,13,3947,2021-07-21T16:00:01.947
295,2021-01-02T00:00:00.000,Asian,48,3995,2021-07-21T16:00:01.947
296,2021-01-03T00:00:00.000,Asian,40,4035,2021-07-21T16:00:01.947
297,2021-01-04T00:00:00.000,Asian,125,4160,2021-07-21T16:00:01.947
298,2021-01-05T00:00:00.000,Asian,84,4244,2021-07-21T16:00:01.947
299,2021-01-06T00:00:00.000,Asian,82,4326,2021-07-21T16:00:01.947
300,2021-01-07T00:00:00.000,Asian,90,4416,2021-07-21T16:00:01.947
301,2021-01-08T00:00:00.000,Asian,87,4503,2021-07-21T16:00:01.947
302,2021-01-09T00:00:00.000,Asian,55,4558,2021-07-21T16:00:01.947
303,2021-01-10T00:00:00.000,Asian,17,4575,2021-07-21T16:00:01.947
304,2021-01-11T00:00:00.000,Asian,89,4664,2021-07-21T16:00:01.947
305,2021-01-12T00:00:00.000,Asian,65,4729,2021-07-21T16:00:01.947
306,2021-01-13T00:00:00.000,Asian,84,4813,2021-07-21T16:00:01.947
307,2021-01-14T00:00:00.000,Asian,72,4885,2021-07-21T16:00:01.947
308,2021-01-15T00:00:00.000,Asian,63,4948,2021-07-21T16:00:01.947
309,2021-01-16T00:00:00.000,Asian,51,4999,2021-07-21T16:00:01.947
310,2021-01-17T00:00:00.000,Asian,30,5029,2021-07-21T16:00:01.947
311,2021-01-18T00:00:00.000,Asian,37,5066,2021-07-21T16:00:01.947
312,2021-01-19T00:00:00.000,Asian,37,5103,2021-07-21T16:00:01.947
313,2021-01-20T00:00:00.000,Asian,71,5174,2021-07-21T16:00:01.947
314,2021-01-21T00:00:00.000,Asian,41,5215,2021-07-21T16:00:01.947
315,2021-01-22T00:00:00.000,Asian,41,5256,2021-07-21T16:00:01.947
316,2021-01-23T00:00:00.000,Asian,21,5277,2021-07-21T16:00:01.947
317,2021-01-24T00:00:00.000,Asian,17,5294,2021-07-21T16:00:01.947
318,2021-01-25T00:00:00.000,Asian,48,5342,2021-07-21T16:00:01.947
319,2021-01-26T00:00:00.000,Asian,25,5367,2021-07-21T16:00:01.947
320,2021-01-27T00:00:00.000,Asian,44,5411,2021-07-21T16:00:01.947
321,2021-01-28T00:00:00.000,Asian,45,5456,2021-07-21T16:00:01.947
322,2021-01-29T00:00:00.000,Asian,27,5483,2021-07-21T16:00:01.947
323,2021-01-30T00:00:00.000,Asian,30,5513,2021-07-21T16:00:01.947
324,2021-01-31T00:00:00.000,Asian,29,5542,2021-07-21T16:00:01.947
325,2021-02-01T00:00:00.000,Asian,34,5576,2021-07-21T16:00:01.947
326,2021-02-02T00:00:00.000,Asian,34,5610,2021-07-21T16:00:01.947
327,2021-02-03T00:00:00.000,Asian,60,5670,2021-07-21T16:00:01.947
328,2021-02-04T00:00:00.000,Asian,51,5721,2021-07-21T16:00:01.947
329,2021-02-05T00:00:00.000,Asian,30,5751,2021-07-21T16:00:01.947
330,2021-02-06T00:00:00.000,Asian,35,5786,2021-07-21T16:00:01.947
331,2021-02-07T00:00:00.000,Asian,18,5804,2021-07-21T16:00:01.947
332,2021-02-08T00:00:00.000,Asian,36,5840,2021-07-21T16:00:01.947
333,2021-02-09T00:00:00.000,Asian,28,5868,2021-07-21T16:00:01.947
334,2021-02-10T00:00:00.000,Asian,34,5902,2021-07-21T16:00:01.947
335,2021-02-11T00:00:00.000,Asian,28,5930,2021-07-21T16:00:01.947
336,2021-02-12T00:00:00.000,Asian,24,5954,2021-07-21T16:00:01.947
337,2021-02-13T00:00:00.000,Asian,14,5968,2021-07-21T16:00:01.947
338,2021-02-14T00:00:00.000,Asian,12,5980,2021-07-21T16:00:01.947
339,2021-02-15T00:00:00.000,Asian,18,5998,2021-07-21T16:00:01.947
340,2021-02-16T00:00:00.000,Asian,20,6018,2021-07-21T16:00:01.947
341,2021-02-17T00:00:00.000,Asian,28,6046,2021-07-21T16:00:01.947
342,2021-02-18T00:00:00.000,Asian,17,6063,2021-07-21T16:00:01.947
343,2021-02-19T00:00:00.000,Asian,24,6087,2021-07-21T16:00:01.947
344,2021-02-20T00:00:00.000,Asian,9,6096,2021-07-21T16:00:01.947
345,2021-02-21T00:00:00.000,Asian,9,6105,2021-07-21T16:00:01.947
346,2021-02-22T00:00:00.000,Asian,26,6131,2021-07-21T16:00:01.947
347,2021-02-23T00:00:00.000,Asian,17,6148,2021-07-21T16:00:01.947
348,2021-02-24T00:00:00.000,Asian,15,6163,2021-07-21T16:00:01.947
349,2021-02-25T00:00:00.000,Asian,16,6179,2021-07-21T16:00:01.947
350,2021-02-26T00:00:00.000,Asian,10,6189,2021-07-21T16:00:01.947
351,2021-02-27T00:00:00.000,Asian,8,6197,2021-07-21T16:00:01.947
352,2021-02-28T00:00:00.000,Asian,7,6204,2021-07-21T16:00:01.947
353,2021-03-01T00:00:00.000,Asian,10,6214,2021-07-21T16:00:01.947
354,2021-03-02T00:00:00.000,Asian,11,6225,2021-07-21T16:00:01.947
355,2021-03-03T00:00:00.000,Asian,8,6233,2021-07-21T16:00:01.947
356,2021-03-04T00:00:00.000,Asian,6,6239,2021-07-21T16:00:01.947
357,2021-03-05T00:00:00.000,Asian,13,6252,2021-07-21T16:00:01.947
358,2021-03-06T00:00:00.000,Asian,2,6254,2021-07-21T16:00:01.947
359,2021-03-07T00:00:00.000,Asian,4,6258,2021-07-21T16:00:01.947
360,2021-03-08T00:00:00.000,Asian,9,6267,2021-07-21T16:00:01.947
361,2021-03-09T00:00:00.000,Asian,7,6274,2021-07-21T16:00:01.947
362,2021-03-10T00:00:00.000,Asian,6,6280,2021-07-21T16:00:01.947
363,2021-03-11T00:00:00.000,Asian,9,6289,2021-07-21T16:00:01.947
364,2021-03-12T00:00:00.000,Asian,9,6298,2021-07-21T16:00:01.947
365,2021-03-13T00:00:00.000,Asian,4,6302,2021-07-21T16:00:01.947
366,2021-03-14T00:00:00.000,Asian,0,6302,2021-07-21T16:00:01.947
367,2021-03-15T00:00:00.000,Asian,7,6309,2021-07-21T16:00:01.947
368,2021-03-16T00:00:00.000,Asian,4,6313,2021-07-21T16:00:01.947
369,2021-03-17T00:00:00.000,Asian,9,6322,2021-07-21T16:00:01.947
370,2021-03-18T00:00:00.000,Asian,3,6325,2021-07-21T16:00:01.947
371,2021-03-19T00:00:00.000,Asian,12,6337,2021-07-21T16:00:01.947
372,2021-03-20T00:00:00.000,Asian,9,6346,2021-07-21T16:00:01.947
373,2021-03-21T00:00:00.000,Asian,5,6351,2021-07-21T16:00:01.947
374,2021-03-22T00:00:00.000,Asian,6,6357,2021-07-21T16:00:01.947
375,2021-03-23T00:00:00.000,Asian,3,6360,2021-07-21T16:00:01.947
376,2021-03-24T00:00:00.000,Asian,8,6368,2021-07-21T16:00:01.947
377,2021-03-25T00:00:00.000,Asian,11,6379,2021-07-21T16:00:01.947
378,2021-03-26T00:00:00.000,Asian,5,6384,2021-07-21T16:00:01.947
379,2021-03-27T00:00:00.000,Asian,6,6390,2021-07-21T16:00:01.947
380,2021-03-28T00:00:00.000,Asian,3,6393,2021-07-21T16:00:01.947
381,2021-03-29T00:00:00.000,Asian,13,6406,2021-07-21T16:00:01.947
382,2021-03-30T00:00:00.000,Asian,11,6417,2021-07-21T16:00:01.947
383,2021-03-31T00:00:00.000,Asian,10,6427,2021-07-21T16:00:01.947
384,2021-04-01T00:00:00.000,Asian,6,6433,2021-07-21T16:00:01.947
385,2021-04-02T00:00:00.000,Asian,8,6441,2021-07-21T16:00:01.947
386,2021-04-03T00:00:00.000,Asian,3,6444,2021-07-21T16:00:01.947
387,2021-04-04T00:00:00.000,Asian,5,6449,2021-07-21T16:00:01.947
388,2021-04-05T00:00:00.000,Asian,18,6467,2021-07-21T16:00:01.947
389,2021-04-06T00:00:00.000,Asian,6,6473,2021-07-21T16:00:01.947
390,2021-04-07T00:00:00.000,Asian,7,6480,2021-07-21T16:00:01.947
391,2021-04-08T00:00:00.000,Asian,11,6491,2021-07-21T16:00:01.947
392,2021-04-09T00:00:00.000,Asian,5,6496,2021-07-21T16:00:01.947
393,2021-04-10T00:00:00.000,Asian,7,6503,2021-07-21T16:00:01.947
394,2021-04-11T00:00:00.000,Asian,7,6510,2021-07-21T16:00:01.947
395,2021-04-12T00:00:00.000,Asian,7,6517,2021-07-21T16:00:01.947
396,2021-04-13T00:00:00.000,Asian,10,6527,2021-07-21T16:00:01.947
397,2021-04-14T00:00:00.000,Asian,3,6530,2021-07-21T16:00:01.947
398,2021-04-15T00:00:00.000,Asian,5,6535,2021-07-21T16:00:01.947
399,2021-04-16T00:00:00.000,Asian,7,6542,2021-07-21T16:00:01.947
400,2021-04-17T00:00:00.000,Asian,2,6544,2021-07-21T16:00:01.947
401,2021-04-18T00:00:00.000,Asian,2,6546,2021-07-21T16:00:01.947
402,2021-04-19T00:00:00.000,Asian,4,6550,2021-07-21T16:00:01.947
403,2021-04-20T00:00:00.000,Asian,4,6554,2021-07-21T16:00:01.947
404,2021-04-21T00:00:00.000,Asian,8,6562,2021-07-21T16:00:01.947
405,2021-04-22T00:00:00.000,Asian,4,6566,2021-07-21T16:00:01.947
406,2021-04-23T00:00:00.000,Asian,5,6571,2021-07-21T16:00:01.947
407,2021-04-24T00:00:00.000,Asian,2,6573,2021-07-21T16:00:01.947
408,2021-04-25T00:00:00.000,Asian,2,6575,2021-07-21T16:00:01.947
409,2021-04-26T00:00:00.000,Asian,6,6581,2021-07-21T16:00:01.947
410,2021-04-27T00:00:00.000,Asian,3,6584,2021-07-21T16:00:01.947
411,2021-04-28T00:00:00.000,Asian,7,6591,2021-07-21T16:00:01.947
412,2021-04-29T00:00:00.000,Asian,2,6593,2021-07-21T16:00:01.947
413,2021-04-30T00:00:00.000,Asian,2,6595,2021-07-21T16:00:01.947
414,2021-05-01T00:00:00.000,Asian,7,6602,2021-07-21T16:00:01.947
415,2021-05-02T00:00:00.000,Asian,3,6605,2021-07-21T16:00:01.947
416,2021-05-03T00:00:00.000,Asian,2,6607,2021-07-21T16:00:01.947
417,2021-05-04T00:00:00.000,Asian,2,6609,2021-07-21T16:00:01.947
418,2021-05-05T00:00:00.000,Asian,6,6615,2021-07-21T16:00:01.947
419,2021-05-06T00:00:00.000,Asian,1,6616,2021-07-21T16:00:01.947
420,2021-05-07T00:00:00.000,Asian,3,6619,2021-07-21T16:00:01.947
421,2021-05-08T00:00:00.000,Asian,2,6621,2021-07-21T16:00:01.947
422,2021-05-09T00:00:00.000,Asian,1,6622,2021-07-21T16:00:01.947
423,2021-05-10T00:00:00.000,Asian,4,6626,2021-07-21T16:00:01.947
424,2021-05-11T00:00:00.000,Asian,8,6634,2021-07-21T16:00:01.947
425,2021-05-12T00:00:00.000,Asian,6,6640,2021-07-21T16:00:01.947
426,2021-05-13T00:00:00.000,Asian,4,6644,2021-07-21T16:00:01.947
427,2021-05-14T00:00:00.000,Asian,5,6649,2021-07-21T16:00:01.947
428,2021-05-15T00:00:00.000,Asian,0,6649,2021-07-21T16:00:01.947
429,2021-05-16T00:00:00.000,Asian,5,6654,2021-07-21T16:00:01.947
430,2021-05-17T00:00:00.000,Asian,3,6657,2021-07-21T16:00:01.947
431,2021-05-18T00:00:00.000,Asian,2,6659,2021-07-21T16:00:01.947
432,2021-05-19T00:00:00.000,Asian,4,6663,2021-07-21T16:00:01.947
433,2021-05-20T00:00:00.000,Asian,1,6664,2021-07-21T16:00:01.947
434,2021-05-21T00:00:00.000,Asian,0,6664,2021-07-21T16:00:01.947
435,2021-05-22T00:00:00.000,Asian,0,6664,2021-07-21T16:00:01.947
436,2021-05-23T00:00:00.000,Asian,0,6664,2021-07-21T16:00:01.947
437,2021-05-24T00:00:00.000,Asian,2,6666,2021-07-21T16:00:01.947
438,2021-05-25T00:00:00.000,Asian,0,6666,2021-07-21T16:00:01.947
439,2021-05-26T00:00:00.000,Asian,4,6670,2021-07-21T16:00:01.947
440,2021-05-27T00:00:00.000,Asian,2,6672,2021-07-21T16:00:01.947
441,2021-05-28T00:00:00.000,Asian,1,6673,2021-07-21T16:00:01.947
442,2021-05-29T00:00:00.000,Asian,0,6673,2021-07-21T16:00:01.947
443,2021-05-30T00:00:00.000,Asian,1,6674,2021-07-21T16:00:01.947
444,2021-05-31T00:00:00.000,Asian,0,6674,2021-07-21T16:00:01.947
445,2021-06-01T00:00:00.000,Asian,1,6675,2021-07-21T16:00:01.947
446,2021-06-02T00:00:00.000,Asian,2,6677,2021-07-21T16:00:01.947
447,2021-06-03T00:00:00.000,Asian,5,6682,2021-07-21T16:00:01.947
448,2021-06-04T00:00:00.000,Asian,2,6684,2021-07-21T16:00:01.947
449,2021-06-05T00:00:00.000,Asian,2,6686,2021-07-21T16:00:01.947
450,2021-06-06T00:00:00.000,Asian,0,6686,2021-07-21T16:00:01.947
451,2021-06-07T00:00:00.000,Asian,1,6687,2021-07-21T16:00:01.947
452,2021-06-08T00:00:00.000,Asian,0,6687,2021-07-21T16:00:01.947
453,2021-06-09T00:00:00.000,Asian,1,6688,2021-07-21T16:00:01.947
454,2021-06-10T00:00:00.000,Asian,3,6691,2021-07-21T16:00:01.947
455,2021-06-11T00:00:00.000,Asian,1,6692,2021-07-21T16:00:01.947
456,2021-06-12T00:00:00.000,Asian,2,6694,2021-07-21T16:00:01.947
457,2021-06-13T00:00:00.000,Asian,0,6694,2021-07-21T16:00:01.947
458,2021-06-14T00:00:00.000,Asian,0,6694,2021-07-21T16:00:01.947
459,2021-06-15T00:00:00.000,Asian,0,6694,2021-07-21T16:00:01.947
460,2021-06-16T00:00:00.000,Asian,1,6695,2021-07-21T16:00:01.947
461,2021-06-17T00:00:00.000,Asian,3,6698,2021-07-21T16:00:01.947
462,2021-06-18T00:00:00.000,Asian,1,6699,2021-07-21T16:00:01.947
463,2021-06-19T00:00:00.000,Asian,0,6699,2021-07-21T16:00:01.947
464,2021-06-20T00:00:00.000,Asian,0,6699,2021-07-21T16:00:01.947
465,2021-06-21T00:00:00.000,Asian,3,6702,2021-07-21T16:00:01.947
466,2021-06-22T00:00:00.000,Asian,2,6704,2021-07-21T16:00:01.947
467,2021-06-23T00:00:00.000,Asian,1,6705,2021-07-21T16:00:01.947
468,2021-06-24T00:00:00.000,Asian,3,6708,2021-07-21T16:00:01.947
469,2021-06-25T00:00:00.000,Asian,3,6711,2021-07-21T16:00:01.947
470,2021-06-26T00:00:00.000,Asian,1,6712,2021-07-21T16:00:01.947
471,2021-06-27T00:00:00.000,Asian,1,6713,2021-07-21T16:00:01.947
472,2021-06-28T00:00:00.000,Asian,2,6715,2021-07-21T16:00:01.947
473,2021-06-29T00:00:00.000,Asian,13,6728,2021-07-21T16:00:01.947
474,2021-06-30T00:00:00.000,Asian,7,6735,2021-07-21T16:00:01.947
475,2021-07-01T00:00:00.000,Asian,4,6739,2021-07-21T16:00:01.947
476,2021-07-02T00:00:00.000,Asian,9,6748,2021-07-21T16:00:01.947
477,2021-07-03T00:00:00.000,Asian,6,6754,2021-07-21T16:00:01.947
478,2021-07-04T00:00:00.000,Asian,0,6754,2021-07-21T16:00:01.947
479,2021-07-05T00:00:00.000,Asian,4,6758,2021-07-21T16:00:01.947
480,2021-07-06T00:00:00.000,Asian,17,6775,2021-07-21T16:00:01.947
481,2021-07-07T00:00:00.000,Asian,18,6793,2021-07-21T16:00:01.947
482,2021-07-08T00:00:00.000,Asian,26,6819,2021-07-21T16:00:01.947
483,2021-07-09T00:00:00.000,Asian,10,6829,2021-07-21T16:00:01.947
484,2021-07-10T00:00:00.000,Asian,15,6844,2021-07-21T16:00:01.947
485,2021-07-11T00:00:00.000,Asian,8,6852,2021-07-21T16:00:01.947
486,2021-07-12T00:00:00.000,Asian,14,6866,2021-07-21T16:00:01.947
487,2021-07-13T00:00:00.000,Asian,30,6896,2021-07-21T16:00:01.947
488,2021-07-14T00:00:00.000,Asian,19,6915,2021-07-21T16:00:01.947
489,2021-07-15T00:00:00.000,Asian,32,6947,2021-07-21T16:00:01.947
490,2021-07-16T00:00:00.000,Asian,16,6963,2021-07-21T16:00:01.947
491,2021-07-17T00:00:00.000,Asian,10,6973,2021-07-21T16:00:01.947
492,2020-04-01T00:00:00.000,Native Hawaiian or Other Pacific Islander,3,7,2021-07-21T16:00:01.947
493,2020-04-02T00:00:00.000,Native Hawaiian or Other Pacific Islander,0,7,2021-07-21T16:00:01.947
494,2020-04-03T00:00:00.000,Native Hawaiian or Other Pacific Islander,0,7,2021-07-21T16:00:01.947
495,2020-04-04T00:00:00.000,Native Hawaiian or Other Pacific Islander,0,7,2021-07-21T16:00:01.947
496,2020-04-05T00:00:00.000,Native Hawaiian or Other Pacific Islander,0,7,2021-07-21T16:00:01.947
497,2020-04-06T00:00:00.000,Native Hawaiian or Other Pacific Islander,1,8,2021-07-21T16:00:01.947
498,2020-04-07T00:00:00.000,Native Hawaiian or Other Pacific Islander,1,9,2021-07-21T16:00:01.947
499,2020-04-08T00:00:00.000,Native Hawaiian or Other Pacific Islander,1,10,2021-07-21T16:00:01.947
500,2020-04-09T00:00:00.000,Native Hawaiian or Other Pacific Islander,1,11,2021-07-21T16:00:01.947
501,2020-04-10T00:00:00.000,Native Hawaiian or Other Pacific Islander,0,11,2021-07-21T16:00:01.947
502,2020-04-11T00:00:00.000,Native Hawaiian or Other Pacific Islander,0,11,2021-07-21T16:00:01.947
503,2020-04-12T00:00:00.000,Native Hawaiian or Other Pacific Islander,2,13,2021-07-21T16:00:01.947
504,2020-04-13T00:00:00.000,Native Hawaiian or Other Pacific Islander,1,14,2021-07-21T16:00:01.947
505,2020-04-14T00:00:00.000,Native Hawaiian or Other Pacific Islander,2,16,2021-07-21T16:00:01.947
506,2020-04-15T00:00:00.000,Native Hawaiian or Other Pacific Islander,0,16,2021-07-21T16:00:01.947
507,2020-04-16T00:00:00.000,Native Hawaiian or Other Pacific Islander,1,17,2021-07-21T16:00:01.947
508,2020-04-17T00:00:00.000,Native Hawaiian or Other Pacific Islander,0,17,2021-07-21T16:00:01.947
509,2020-04-18T00:00:00.000,Native Hawaiian or Other Pacific Islander,0,17,2021-07-21T16:00:01.947
510,2020-04-19T00:00:00.000,Native Hawaiian or Other Pacific Islander,0,17,2021-07-21T16:00:01.947
511,2020-04-20T00:00:00.000,Native Hawaiian or Other Pacific Islander,2,19,2021-07-21T16:00:01.947
512,2020-04-21T00:00:00.000,Native Hawaiian or Other Pacific Islander,0,19,2021-07-21T16:00:01.947
513,2020-04-22T00:00:00.000,Native Hawaiian or Other Pacific Islander,2,21,2021-07-21T16:00:01.947
514,2020-04-23T00:00:00.000,Native Hawaiian or Other Pacific Islander,2,23,2021-07-21T16:00:01.947
515,2020-04-24T00:00:00.000,Native Hawaiian or Other Pacific Islander,2,25,2021-07-21T16:00:01.947
516,2020-04-25T00:00:00.000,Native Hawaiian or Other Pacific Islander,0,25,2021-07-21T16:00:01.947
517,2020-04-26T00:00:00.000,Native Hawaiian or Other Pacific Islander,0,25,2021-07-21T16:00:01.947
518,2020-04-27T00:00:00.000,Native Hawaiian or Other Pacific Islander,1,26,2021-07-21T16:00:01.947
519,2020-04-28T00:00:00.000,Native Hawaiian or Other Pacific Islander,0,26,2021-07-21T16:00:01.947
520,2020-04-29T00:00:00.000,Native Hawaiian or Other Pacific Islander,0,26,2021-07-21T16:00:01.947
521,2020-04-30T00:00:00.000,Native Hawaiian or Other Pacific Islander,0,26,2021-07-21T16:00:01.947
522,2020-05-01T00:00:00.000,Native Hawaiian or Other Pacific Islander,0,26,2021-07-21T16:00:01.947
523,2020-05-02T00:00:00.000,Native Hawaiian or Other Pacific Islander,0,26,2021-07-21T16:00:01.947
524,2020-05-03T00:00:00.000,Native Hawaiian or Other Pacific Islander,0,26,2021-07-21T16:00:01.947
525,2020-05-04T00:00:00.000,Native Hawaiian or Other Pacific Islander,0,26,2021-07-21T16:00:01.947
526,2020-05-05T00:00:00.000,Native Hawaiian or Other Pacific Islander,0,26,2021-07-21T16:00:01.947
527,2020-05-06T00:00:00.000,Native Hawaiian or Other Pacific Islander,0,26,2021-07-21T16:00:01.947
528,2020-05-07T00:00:00.000,Native Hawaiian or Other Pacific Islander,0,26,2021-07-21T16:00:01.947
529,2020-05-08T00:00:00.000,Native Hawaiian or Other Pacific Islander,0,26,2021-07-21T16:00:01.947
530,2020-05-09T00:00:00.000,Native Hawaiian or Other Pacific Islander,0,26,2021-07-21T16:00:01.947
531,2020-05-10T00:00:00.000,Native Hawaiian or Other Pacific Islander,0,26,2021-07-21T16:00:01.947
532,2020-05-11T00:00:00.000,Native Hawaiian or Other Pacific Islander,1,27,2021-07-21T16:00:01.947
533,2020-05-12T00:00:00.000,Native Hawaiian or Other Pacific Islander,0,27,2021-07-21T16:00:01.947
534,2020-05-13T00:00:00.000,Native Hawaiian or Other Pacific Islander,1,28,2021-07-21T16:00:01.947
535,2020-05-14T00:00:00.000,Native Hawaiian or Other Pacific Islander,1,29,2021-07-21T16:00:01.947
536,2020-05-15T00:00:00.000,Native Hawaiian or Other Pacific Islander,1,30,2021-07-21T16:00:01.947
537,2020-05-16T00:00:00.000,Native Hawaiian or Other Pacific Islander,0,30,2021-07-21T16:00:01.947
538,2020-05-17T00:00:00.000,Native Hawaiian or Other Pacific Islander,0,30,2021-07-21T16:00:01.947
539,2020-05-18T00:00:00.000,Native Hawaiian or Other Pacific Islander,0,30,2021-07-21T16:00:01.947
540,2020-05-19T00:00:00.000,Native Hawaiian or Other Pacific Islander,0,30,2021-07-21T16:00:01.947
541,2020-05-20T00:00:00.000,Native Hawaiian or Other Pacific Islander,0,30,2021-07-21T16:00:01.947
542,2020-05-21T00:00:00.000,Native Hawaiian or Other Pacific Islander,0,30,2021-07-21T16:00:01.947
543,2020-05-22T00:00:00.000,Native Hawaiian or Other Pacific Islander,0,30,2021-07-21T16:00:01.947
544,2020-05-23T00:00:00.000,Native Hawaiian or Other Pacific Islander,0,30,2021-07-21T16:00:01.947
545,2020-05-24T00:00:00.000,Native Hawaiian or Other Pacific Islander,0,30,2021-07-21T16:00:01.947
546,2020-05-25T00:00:00.000,Native Hawaiian or Other Pacific Islander,1,31,2021-07-21T16:00:01.947
547,2020-05-26T00:00:00.000,Native Hawaiian or Other Pacific Islander,0,31,2021-07-21T16:00:01.947
548,2020-05-27T00:00:00.000,Native Hawaiian or Other Pacific Islander,0,31,2021-07-21T16:00:01.947
549,2020-05-28T00:00:00.000,Native Hawaiian or Other Pacific Islander,0,31,2021-07-21T16:00:01.947
550,2020-05-29T00:00:00.000,Native Hawaiian or Other Pacific Islander,1,32,2021-07-21T16:00:01.947
551,2020-05-30T00:00:00.000,Native Hawaiian or Other Pacific Islander,0,32,2021-07-21T16:00:01.947
552,2020-05-31T00:00:00.000,Native Hawaiian or Other Pacific Islander,0,32,2021-07-21T16:00:01.947
553,2020-06-01T00:00:00.000,Native Hawaiian or Other Pacific Islander,1,33,2021-07-21T16:00:01.947
554,2020-06-02T00:00:00.000,Native Hawaiian or Other Pacific Islander,0,33,2021-07-21T16:00:01.947
555,2020-06-03T00:00:00.000,Native Hawaiian or Other Pacific Islander,0,33,2021-07-21T16:00:01.947
556,2020-06-04T00:00:00.000,Native Hawaiian or Other Pacific Islander,0,33,2021-07-21T16:00:01.947
557,2020-06-05T00:00:00.000,Native Hawaiian or Other Pacific Islander,0,33,2021-07-21T16:00:01.947
558,2020-06-06T00:00:00.000,Native Hawaiian or Other Pacific Islander,0,33,2021-07-21T16:00:01.947
559,2020-06-07T00:00:00.000,Native Hawaiian or Other Pacific Islander,0,33,2021-07-21T16:00:01.947
560,2020-06-08T00:00:00.000,Native Hawaiian or Other Pacific Islander,0,33,2021-07-21T16:00:01.947
561,2020-06-09T00:00:00.000,Native Hawaiian or Other Pacific Islander,1,34,2021-07-21T16:00:01.947
562,2020-06-10T00:00:00.000,Native Hawaiian or Other Pacific Islander,0,34,2021-07-21T16:00:01.947
563,2020-06-11T00:00:00.000,Native Hawaiian or Other Pacific Islander,0,34,2021-07-21T16:00:01.947
564,2020-06-12T00:00:00.000,Native Hawaiian or Other Pacific Islander,0,34,2021-07-21T16:00:01.947
565,2020-06-13T00:00:00.000,Native Hawaiian or Other Pacific Islander,0,34,2021-07-21T16:00:01.947
566,2020-06-14T00:00:00.000,Native Hawaiian or Other Pacific Islander,0,34,2021-07-21T16:00:01.947
567,2020-06-15T00:00:00.000,Native Hawaiian or Other Pacific Islander,0,34,2021-07-21T16:00:01.947
568,2020-06-16T00:00:00.000,Native Hawaiian or Other Pacific Islander,0,34,2021-07-21T16:00:01.947
569,2020-06-17T00:00:00.000,Native Hawaiian or Other Pacific Islander,0,34,2021-07-21T16:00:01.947
570,2020-06-18T00:00:00.000,Native Hawaiian or Other Pacific Islander,1,35,2021-07-21T16:00:01.947
571,2020-06-19T00:00:00.000,Native Hawaiian or Other Pacific Islander,0,35,2021-07-21T16:00:01.947
572,2020-06-20T00:00:00.000,Native Hawaiian or Other Pacific Islander,0,35,2021-07-21T16:00:01.947
573,2020-06-21T00:00:00.000,Native Hawaiian or Other Pacific Islander,1,36,2021-07-21T16:00:01.947
574,2020-06-22T00:00:00.000,Native Hawaiian or Other Pacific Islander,0,36,2021-07-21T16:00:01.947
575,2020-06-23T00:00:00.000,Native Hawaiian or Other Pacific Islander,0,36,2021-07-21T16:00:01.947
576,2020-06-24T00:00:00.000,Native Hawaiian or Other Pacific Islander,0,36,2021-07-21T16:00:01.947
577,2020-06-25T00:00:00.000,Native Hawaiian or Other Pacific Islander,0,36,2021-07-21T16:00:01.947
578,2020-06-26T00:00:00.000,Native Hawaiian or Other Pacific Islander,0,36,2021-07-21T16:00:01.947
579,2020-06-27T00:00:00.000,Native Hawaiian or Other Pacific Islander,0,36,2021-07-21T16:00:01.947
580,2020-06-28T00:00:00.000,Native Hawaiian or Other Pacific Islander,0,36,2021-07-21T16:00:01.947
581,2020-06-29T00:00:00.000,Native Hawaiian or Other Pacific Islander,1,37,2021-07-21T16:00:01.947
582,2020-06-30T00:00:00.000,Native Hawaiian or Other Pacific Islander,1,38,2021-07-21T16:00:01.947
583,2020-07-01T00:00:00.000,Native Hawaiian or Other Pacific Islander,1,39,2021-07-21T16:00:01.947
584,2020-07-02T00:00:00.000,Native Hawaiian or Other Pacific Islander,1,40,2021-07-21T16:00:01.947
585,2020-07-03T00:00:00.000,Native Hawaiian or Other Pacific Islander,0,40,2021-07-21T16:00:01.947
586,2020-07-04T00:00:00.000,Native Hawaiian or Other Pacific Islander,0,40,2021-07-21T16:00:01.947
587,2020-07-05T00:00:00.000,Native Hawaiian or Other Pacific Islander,2,42,2021-07-21T16:00:01.947
588,2020-07-06T00:00:00.000,Native Hawaiian or Other Pacific Islander,0,42,2021-07-21T16:00:01.947
589,2020-07-07T00:00:00.000,Native Hawaiian or Other Pacific Islander,0,42,2021-07-21T16:00:01.947
590,2020-07-08T00:00:00.000,Native Hawaiian or Other Pacific Islander,2,44,2021-07-21T16:00:01.947
591,2020-07-09T00:00:00.000,Native Hawaiian or Other Pacific Islander,2,46,2021-07-21T16:00:01.947
592,2020-07-10T00:00:00.000,Native Hawaiian or Other Pacific Islander,0,46,2021-07-21T16:00:01.947
593,2020-07-11T00:00:00.000,Native Hawaiian or Other Pacific Islander,3,49,2021-07-21T16:00:01.947
594,2020-07-12T00:00:00.000,Native Hawaiian or Other Pacific Islander,0,49,2021-07-21T16:00:01.947
595,2020-07-13T00:00:00.000,Native Hawaiian or Other Pacific Islander,1,50,2021-07-21T16:00:01.947
596,2020-07-14T00:00:00.000,Native Hawaiian or Other Pacific Islander,1,51,2021-07-21T16:00:01.947
597,2020-07-15T00:00:00.000,Native Hawaiian or Other Pacific Islander,3,54,2021-07-21T16:00:01.947
598,2020-07-16T00:00:00.000,Native Hawaiian or Other Pacific Islander,3,57,2021-07-21T16:00:01.947
599,2020-07-17T00:00:00.000,Native Hawaiian or Other Pacific Islander,0,57,2021-07-21T16:00:01.947
600,2020-07-18T00:00:00.000,Native Hawaiian or Other Pacific Islander,0,57,2021-07-21T16:00:01.947
601,2020-07-19T00:00:00.000,Native Hawaiian or Other Pacific Islander,0,57,2021-07-21T16:00:01.947
602,2020-07-20T00:00:00.000,Native Hawaiian or Other Pacific Islander,4,61,2021-07-21T16:00:01.947
603,2020-07-21T00:00:00.000,Native Hawaiian or Other Pacific Islander,2,63,2021-07-21T16:00:01.947
604,2020-07-22T00:00:00.000,Native Hawaiian or Other Pacific Islander,5,68,2021-07-21T16:00:01.947
605,2020-07-23T00:00:00.000,Native Hawaiian or Other Pacific Islander,3,71,2021-07-21T16:00:01.947
606,2020-07-24T00:00:00.000,Native Hawaiian or Other Pacific Islander,2,73,2021-07-21T16:00:01.947
607,2020-07-25T00:00:00.000,Native Hawaiian or Other Pacific Islander,3,76,2021-07-21T16:00:01.947
608,2020-07-26T00:00:00.000,Native Hawaiian or Other Pacific Islander,0,76,2021-07-21T16:00:01.947
609,2020-07-27T00:00:00.000,Native Hawaiian or Other Pacific Islander,2,78,2021-07-21T16:00:01.947
610,2020-07-28T00:00:00.000,Native Hawaiian or Other Pacific Islander,5,83,2021-07-21T16:00:01.947
611,2020-07-29T00:00:00.000,Native Hawaiian or Other Pacific Islander,1,84,2021-07-21T16:00:01.947
612,2020-07-30T00:00:00.000,Native Hawaiian or Other Pacific Islander,1,85,2021-07-21T16:00:01.947
613,2020-07-31T00:00:00.000,Native Hawaiian or Other Pacific Islander,1,86,2021-07-21T16:00:01.947
614,2020-08-01T00:00:00.000,Native Hawaiian or Other Pacific Islander,1,87,2021-07-21T16:00:01.947
615,2020-08-02T00:00:00.000,Native Hawaiian or Other Pacific Islander,4,91,2021-07-21T16:00:01.947
616,2020-08-03T00:00:00.000,Native Hawaiian or Other Pacific Islander,0,91,2021-07-21T16:00:01.947
617,2020-08-04T00:00:00.000,Native Hawaiian or Other Pacific Islander,0,91,2021-07-21T16:00:01.947
618,2020-08-05T00:00:00.000,Native Hawaiian or Other Pacific Islander,4,95,2021-07-21T16:00:01.947
619,2020-08-06T00:00:00.000,Native Hawaiian or Other Pacific Islander,0,95,2021-07-21T16:00:01.947
620,2020-08-07T00:00:00.000,Native Hawaiian or Other Pacific Islander,2,97,2021-07-21T16:00:01.947
621,2020-08-08T00:00:00.000,Native Hawaiian or Other Pacific Islander,0,97,2021-07-21T16:00:01.947
622,2020-08-09T00:00:00.000,Native Hawaiian or Other Pacific Islander,0,97,2021-07-21T16:00:01.947
623,2020-08-10T00:00:00.000,Native Hawaiian or Other Pacific Islander,1,98,2021-07-21T16:00:01.947
624,2020-08-11T00:00:00.000,Native Hawaiian or Other Pacific Islander,3,101,2021-07-21T16:00:01.947
625,2020-08-12T00:00:00.000,Native Hawaiian or Other Pacific Islander,5,106,2021-07-21T16:00:01.947
626,2020-08-13T00:00:00.000,Native Hawaiian or Other Pacific Islander,3,109,2021-07-21T16:00:01.947
627,2020-08-14T00:00:00.000,Native Hawaiian or Other Pacific Islander,0,109,2021-07-21T16:00:01.947
628,2020-08-15T00:00:00.000,Native Hawaiian or Other Pacific Islander,1,110,2021-07-21T16:00:01.947
629,2020-08-16T00:00:00.000,Native Hawaiian or Other Pacific Islander,1,111,2021-07-21T16:00:01.947
630,2020-08-17T00:00:00.000,Native Hawaiian or Other Pacific Islander,5,116,2021-07-21T16:00:01.947
631,2020-08-18T00:00:00.000,Native Hawaiian or Other Pacific Islander,2,118,2021-07-21T16:00:01.947
632,2020-08-19T00:00:00.000,Native Hawaiian or Other Pacific Islander,2,120,2021-07-21T16:00:01.947
633,2020-08-20T00:00:00.000,Native Hawaiian or Other Pacific Islander,2,122,2021-07-21T16:00:01.947
634,2020-08-21T00:00:00.000,Native Hawaiian or Other Pacific Islander,7,129,2021-07-21T16:00:01.947
635,2020-08-22T00:00:00.000,Native Hawaiian or Other Pacific Islander,0,129,2021-07-21T16:00:01.947
636,2020-08-23T00:00:00.000,Native Hawaiian or Other Pacific Islander,1,130,2021-07-21T16:00:01.947
637,2020-08-24T00:00:00.000,Native Hawaiian or Other Pacific Islander,0,130,2021-07-21T16:00:01.947
638,2020-08-25T00:00:00.000,Native Hawaiian or Other Pacific Islander,2,132,2021-07-21T16:00:01.947
639,2020-08-26T00:00:00.000,Native Hawaiian or Other Pacific Islander,0,132,2021-07-21T16:00:01.947
640,2020-08-27T00:00:00.000,Native Hawaiian or Other Pacific Islander,0,132,2021-07-21T16:00:01.947
641,2020-08-28T00:00:00.000,Native Hawaiian or Other Pacific Islander,0,132,2021-07-21T16:00:01.947
642,2020-08-29T00:00:00.000,Native Hawaiian or Other Pacific Islander,2,134,2021-07-21T16:00:01.947
643,2020-08-30T00:00:00.000,Native Hawaiian or Other Pacific Islander,1,135,2021-07-21T16:00:01.947
644,2020-08-31T00:00:00.000,Native Hawaiian or Other Pacific Islander,1,136,2021-07-21T16:00:01.947
645,2020-09-01T00:00:00.000,Native Hawaiian or Other Pacific Islander,2,138,2021-07-21T16:00:01.947
646,2020-09-02T00:00:00.000,Native Hawaiian or Other Pacific Islander,2,140,2021-07-21T16:00:01.947
647,2020-09-03T00:00:00.000,Native Hawaiian or Other Pacific Islander,2,142,2021-07-21T16:00:01.947
648,2020-09-04T00:00:00.000,Native Hawaiian or Other Pacific Islander,0,142,2021-07-21T16:00:01.947
649,2020-09-05T00:00:00.000,Native Hawaiian or Other Pacific Islander,0,142,2021-07-21T16:00:01.947
650,2020-09-06T00:00:00.000,Native Hawaiian or Other Pacific Islander,1,143,2021-07-21T16:00:01.947
651,2020-09-07T00:00:00.000,Native Hawaiian or Other Pacific Islander,1,144,2021-07-21T16:00:01.947
652,2020-09-08T00:00:00.000,Native Hawaiian or Other Pacific Islander,1,145,2021-07-21T16:00:01.947
653,2020-09-09T00:00:00.000,Native Hawaiian or Other Pacific Islander,2,147,2021-07-21T16:00:01.947
654,2020-09-10T00:00:00.000,Native Hawaiian or Other Pacific Islander,1,148,2021-07-21T16:00:01.947
655,2020-09-11T00:00:00.000,Native Hawaiian or Other Pacific Islander,0,148,2021-07-21T16:00:01.947
656,2020-09-12T00:00:00.000,Native Hawaiian or Other Pacific Islander,0,148,2021-07-21T16:00:01.947
657,2020-09-13T00:00:00.000,Native Hawaiian or Other Pacific Islander,0,148,2021-07-21T16:00:01.947
658,2020-09-14T00:00:00.000,Native Hawaiian or Other Pacific Islander,0,148,2021-07-21T16:00:01.947
659,2020-09-15T00:00:00.000,Native Hawaiian or Other Pacific Islander,1,149,2021-07-21T16:00:01.947
660,2020-09-16T00:00:00.000,Native Hawaiian or Other Pacific Islander,1,150,2021-07-21T16:00:01.947
661,2020-09-17T00:00:00.000,Native Hawaiian or Other Pacific Islander,1,151,2021-07-21T16:00:01.947
662,2020-09-18T00:00:00.000,Native Hawaiian or Other Pacific Islander,0,151,2021-07-21T16:00:01.947
663,2020-09-19T00:00:00.000,Native Hawaiian or Other Pacific Islander,0,151,2021-07-21T16:00:01.947
664,2020-09-20T00:00:00.000,Native Hawaiian or Other Pacific Islander,0,151,2021-07-21T16:00:01.947
665,2020-09-21T00:00:00.000,Native Hawaiian or Other Pacific Islander,2,153,2021-07-21T16:00:01.947
666,2020-09-22T00:00:00.000,Native Hawaiian or Other Pacific Islander,0,153,2021-07-21T16:00:01.947
667,2020-09-23T00:00:00.000,Native Hawaiian or Other Pacific Islander,0,153,2021-07-21T16:00:01.947
668,2020-09-24T00:00:00.000,Native Hawaiian or Other Pacific Islander,1,154,2021-07-21T16:00:01.947
669,2020-09-25T00:00:00.000,Native Hawaiian or Other Pacific Islander,0,154,2021-07-21T16:00:01.947
670,2020-09-26T00:00:00.000,Native Hawaiian or Other Pacific Islander,0,154,2021-07-21T16:00:01.947
671,2020-09-27T00:00:00.000,Native Hawaiian or Other Pacific Islander,0,154,2021-07-21T16:00:01.947
672,2020-09-28T00:00:00.000,Native Hawaiian or Other Pacific Islander,1,155,2021-07-21T16:00:01.947
673,2020-09-29T00:00:00.000,Native Hawaiian or Other Pacific Islander,0,155,2021-07-21T16:00:01.947
674,2020-09-30T00:00:00.000,Native Hawaiian or Other Pacific Islander,1,156,2021-07-21T16:00:01.947
675,2020-10-01T00:00:00.000,Native Hawaiian or Other Pacific Islander,0,156,2021-07-21T16:00:01.947
676,2020-10-02T00:00:00.000,Native Hawaiian or Other Pacific Islander,0,156,2021-07-21T16:00:01.947
677,2020-10-03T00:00:00.000,Native Hawaiian or Other Pacific Islander,0,156,2021-07-21T16:00:01.947
678,2020-10-04T00:00:00.000,Native Hawaiian or Other Pacific Islander,0,156,2021-07-21T16:00:01.947
679,2020-10-05T00:00:00.000,Native Hawaiian or Other Pacific Islander,0,156,2021-07-21T16:00:01.947
680,2020-10-06T00:00:00.000,Native Hawaiian or Other Pacific Islander,1,157,2021-07-21T16:00:01.947
681,2020-10-07T00:00:00.000,Native Hawaiian or Other Pacific Islander,1,158,2021-07-21T16:00:01.947
682,2020-10-08T00:00:00.000,Native Hawaiian or Other Pacific Islander,1,159,2021-07-21T16:00:01.947
683,2020-10-09T00:00:00.000,Native Hawaiian or Other Pacific Islander,1,160,2021-07-21T16:00:01.947
684,2020-10-10T00:00:00.000,Native Hawaiian or Other Pacific Islander,1,161,2021-07-21T16:00:01.947
685,2020-10-11T00:00:00.000,Native Hawaiian or Other Pacific Islander,0,161,2021-07-21T16:00:01.947
686,2020-10-12T00:00:00.000,Native Hawaiian or Other Pacific Islander,0,161,2021-07-21T16:00:01.947
687,2020-10-13T00:00:00.000,Native Hawaiian or Other Pacific Islander,1,162,2021-07-21T16:00:01.947
688,2020-10-14T00:00:00.000,Native Hawaiian or Other Pacific Islander,1,163,2021-07-21T16:00:01.947
689,2020-10-15T00:00:00.000,Native Hawaiian or Other Pacific Islander,1,164,2021-07-21T16:00:01.947
690,2020-10-16T00:00:00.000,Native Hawaiian or Other Pacific Islander,0,164,2021-07-21T16:00:01.947
691,2020-10-17T00:00:00.000,Native Hawaiian or Other Pacific Islander,0,164,2021-07-21T16:00:01.947
692,2020-10-18T00:00:00.000,Native Hawaiian or Other Pacific Islander,0,164,2021-07-21T16:00:01.947
693,2020-10-19T00:00:00.000,Native Hawaiian or Other Pacific Islander,1,165,2021-07-21T16:00:01.947
694,2020-10-20T00:00:00.000,Native Hawaiian or Other Pacific Islander,1,166,2021-07-21T16:00:01.947
695,2020-10-21T00:00:00.000,Native Hawaiian or Other Pacific Islander,0,166,2021-07-21T16:00:01.947
696,2020-10-22T00:00:00.000,Native Hawaiian or Other Pacific Islander,0,166,2021-07-21T16:00:01.947
697,2020-10-23T00:00:00.000,Native Hawaiian or Other Pacific Islander,0,166,2021-07-21T16:00:01.947
698,2020-10-24T00:00:00.000,Native Hawaiian or Other Pacific Islander,0,166,2021-07-21T16:00:01.947
699,2020-10-25T00:00:00.000,Native Hawaiian or Other Pacific Islander,0,166,2021-07-21T16:00:01.947
700,2020-10-26T00:00:00.000,Native Hawaiian or Other Pacific Islander,0,166,2021-07-21T16:00:01.947
701,2020-10-27T00:00:00.000,Native Hawaiian or Other Pacific Islander,0,166,2021-07-21T16:00:01.947
702,2020-10-28T00:00:00.000,Native Hawaiian or Other Pacific Islander,0,166,2021-07-21T16:00:01.947
703,2020-10-29T00:00:00.000,Native Hawaiian or Other Pacific Islander,0,166,2021-07-21T16:00:01.947
704,2020-10-30T00:00:00.000,Native Hawaiian or Other Pacific Islander,4,170,2021-07-21T16:00:01.947
705,2020-10-31T00:00:00.000,Native Hawaiian or Other Pacific Islander,1,171,2021-07-21T16:00:01.947
706,2020-11-01T00:00:00.000,Native Hawaiian or Other Pacific Islander,0,171,2021-07-21T16:00:01.947
707,2020-11-02T00:00:00.000,Native Hawaiian or Other Pacific Islander,0,171,2021-07-21T16:00:01.947
708,2020-11-03T00:00:00.000,Native Hawaiian or Other Pacific Islander,3,174,2021-07-21T16:00:01.947
709,2020-11-04T00:00:00.000,Native Hawaiian or Other Pacific Islander,2,176,2021-07-21T16:00:01.947
710,2020-11-05T00:00:00.000,Native Hawaiian or Other Pacific Islander,0,176,2021-07-21T16:00:01.947
711,2020-11-06T00:00:00.000,Native Hawaiian or Other Pacific Islander,0,176,2021-07-21T16:00:01.947
712,2020-11-07T00:00:00.000,Native Hawaiian or Other Pacific Islander,1,177,2021-07-21T16:00:01.947
713,2020-11-08T00:00:00.000,Native Hawaiian or Other Pacific Islander,0,177,2021-07-21T16:00:01.947
714,2020-11-09T00:00:00.000,Native Hawaiian or Other Pacific Islander,1,178,2021-07-21T16:00:01.947
715,2020-11-10T00:00:00.000,Native Hawaiian or Other Pacific Islander,2,180,2021-07-21T16:00:01.947
716,2020-11-11T00:00:00.000,Native Hawaiian or Other Pacific Islander,0,180,2021-07-21T16:00:01.947
717,2020-11-12T00:00:00.000,Native Hawaiian or Other Pacific Islander,1,181,2021-07-21T16:00:01.947
718,2020-11-13T00:00:00.000,Native Hawaiian or Other Pacific Islander,1,182,2021-07-21T16:00:01.947
719,2020-11-14T00:00:00.000,Native Hawaiian or Other Pacific Islander,1,183,2021-07-21T16:00:01.947
720,2020-11-15T00:00:00.000,Native Hawaiian or Other Pacific Islander,0,183,2021-07-21T16:00:01.947
721,2020-11-16T00:00:00.000,Native Hawaiian or Other Pacific Islander,2,185,2021-07-21T16:00:01.947
722,2020-11-17T00:00:00.000,Native Hawaiian or Other Pacific Islander,0,185,2021-07-21T16:00:01.947
723,2020-11-18T00:00:00.000,Native Hawaiian or Other Pacific Islander,2,187,2021-07-21T16:00:01.947
724,2020-11-19T00:00:00.000,Native Hawaiian or Other Pacific Islander,3,190,2021-07-21T16:00:01.947
725,2020-11-20T00:00:00.000,Native Hawaiian or Other Pacific Islander,4,194,2021-07-21T16:00:01.947
726,2020-11-21T00:00:00.000,Native Hawaiian or Other Pacific Islander,0,194,2021-07-21T16:00:01.947
727,2020-11-22T00:00:00.000,Native Hawaiian or Other Pacific Islander,0,194,2021-07-21T16:00:01.947
728,2020-11-23T00:00:00.000,Native Hawaiian or Other Pacific Islander,2,196,2021-07-21T16:00:01.947
729,2020-11-24T00:00:00.000,Native Hawaiian or Other Pacific Islander,2,198,2021-07-21T16:00:01.947
730,2020-11-25T00:00:00.000,Native Hawaiian or Other Pacific Islander,1,199,2021-07-21T16:00:01.947
731,2020-11-26T00:00:00.000,Native Hawaiian or Other Pacific Islander,1,200,2021-07-21T16:00:01.947
732,2020-11-27T00:00:00.000,Native Hawaiian or Other Pacific Islander,3,203,2021-07-21T16:00:01.947
733,2020-11-28T00:00:00.000,Native Hawaiian or Other Pacific Islander,0,203,2021-07-21T16:00:01.947
734,2020-11-29T00:00:00.000,Native Hawaiian or Other Pacific Islander,0,203,2021-07-21T16:00:01.947
735,2020-11-30T00:00:00.000,Native Hawaiian or Other Pacific Islander,0,203,2021-07-21T16:00:01.947
736,2020-12-01T00:00:00.000,Native Hawaiian or Other Pacific Islander,3,206,2021-07-21T16:00:01.947
737,2020-12-02T00:00:00.000,Native Hawaiian or Other Pacific Islander,2,208,2021-07-21T16:00:01.947
738,2020-12-03T00:00:00.000,Native Hawaiian or Other Pacific Islander,1,209,2021-07-21T16:00:01.947
739,2020-12-04T00:00:00.000,Native Hawaiian or Other Pacific Islander,3,212,2021-07-21T16:00:01.947
740,2020-12-05T00:00:00.000,Native Hawaiian or Other Pacific Islander,3,215,2021-07-21T16:00:01.947
741,2020-12-06T00:00:00.000,Native Hawaiian or Other Pacific Islander,0,215,2021-07-21T16:00:01.947
742,2020-12-07T00:00:00.000,Native Hawaiian or Other Pacific Islander,3,218,2021-07-21T16:00:01.947
743,2020-12-08T00:00:00.000,Native Hawaiian or Other Pacific Islander,3,221,2021-07-21T16:00:01.947
744,2020-12-09T00:00:00.000,Native Hawaiian or Other Pacific Islander,4,225,2021-07-21T16:00:01.947
745,2020-12-10T00:00:00.000,Native Hawaiian or Other Pacific Islander,4,229,2021-07-21T16:00:01.947
746,2020-12-11T00:00:00.000,Native Hawaiian or Other Pacific Islander,4,233,2021-07-21T16:00:01.947
747,2020-12-12T00:00:00.000,Native Hawaiian or Other Pacific Islander,1,234,2021-07-21T16:00:01.947
748,2020-12-13T00:00:00.000,Native Hawaiian or Other Pacific Islander,1,235,2021-07-21T16:00:01.947
749,2020-12-14T00:00:00.000,Native Hawaiian or Other Pacific Islander,6,241,2021-07-21T16:00:01.947
750,2020-12-15T00:00:00.000,Native Hawaiian or Other Pacific Islander,2,243,2021-07-21T16:00:01.947
751,2020-12-16T00:00:00.000,Native Hawaiian or Other Pacific Islander,4,247,2021-07-21T16:00:01.947
752,2020-12-17T00:00:00.000,Native Hawaiian or Other Pacific Islander,3,250,2021-07-21T16:00:01.947
753,2020-12-18T00:00:00.000,Native Hawaiian or Other Pacific Islander,1,251,2021-07-21T16:00:01.947
754,2020-12-19T00:00:00.000,Native Hawaiian or Other Pacific Islander,0,251,2021-07-21T16:00:01.947
755,2020-12-20T00:00:00.000,Native Hawaiian or Other Pacific Islander,1,252,2021-07-21T16:00:01.947
756,2020-12-21T00:00:00.000,Native Hawaiian or Other Pacific Islander,2,254,2021-07-21T16:00:01.947
757,2020-12-22T00:00:00.000,Native Hawaiian or Other Pacific Islander,1,255,2021-07-21T16:00:01.947
758,2020-12-23T00:00:00.000,Native Hawaiian or Other Pacific Islander,1,256,2021-07-21T16:00:01.947
759,2020-12-24T00:00:00.000,Native Hawaiian or Other Pacific Islander,2,258,2021-07-21T16:00:01.947
760,2020-12-25T00:00:00.000,Native Hawaiian or Other Pacific Islander,1,259,2021-07-21T16:00:01.947
761,2020-12-26T00:00:00.000,Native Hawaiian or Other Pacific Islander,3,262,2021-07-21T16:00:01.947
762,2020-12-27T00:00:00.000,Native Hawaiian or Other Pacific Islander,2,264,2021-07-21T16:00:01.947
763,2020-12-28T00:00:00.000,Native Hawaiian or Other Pacific Islander,4,268,2021-07-21T16:00:01.947
764,2020-12-29T00:00:00.000,Native Hawaiian or Other Pacific Islander,3,271,2021-07-21T16:00:01.947
765,2020-12-30T00:00:00.000,Native Hawaiian or Other Pacific Islander,6,277,2021-07-21T16:00:01.947
766,2020-12-31T00:00:00.000,Native Hawaiian or Other Pacific Islander,4,281,2021-07-21T16:00:01.947
767,2021-01-01T00:00:00.000,Native Hawaiian or Other Pacific Islander,0,281,2021-07-21T16:00:01.947
768,2021-01-02T00:00:00.000,Native Hawaiian or Other Pacific Islander,5,286,2021-07-21T16:00:01.947
769,2021-01-03T00:00:00.000,Native Hawaiian or Other Pacific Islander,0,286,2021-07-21T16:00:01.947
770,2021-01-04T00:00:00.000,Native Hawaiian or Other Pacific Islander,4,290,2021-07-21T16:00:01.947
771,2021-01-05T00:00:00.000,Native Hawaiian or Other Pacific Islander,8,298,2021-07-21T16:00:01.947
772,2021-01-06T00:00:00.000,Native Hawaiian or Other Pacific Islander,5,303,2021-07-21T16:00:01.947
773,2021-01-07T00:00:00.000,Native Hawaiian or Other Pacific Islander,16,319,2021-07-21T16:00:01.947
774,2021-01-08T00:00:00.000,Native Hawaiian or Other Pacific Islander,10,329,2021-07-21T16:00:01.947
775,2021-01-09T00:00:00.000,Native Hawaiian or Other Pacific Islander,5,334,2021-07-21T16:00:01.947
776,2021-01-10T00:00:00.000,Native Hawaiian or Other Pacific Islander,1,335,2021-07-21T16:00:01.947
777,2021-01-11T00:00:00.000,Native Hawaiian or Other Pacific Islander,9,344,2021-07-21T16:00:01.947
778,2021-01-12T00:00:00.000,Native Hawaiian or Other Pacific Islander,2,346,2021-07-21T16:00:01.947
779,2021-01-13T00:00:00.000,Native Hawaiian or Other Pacific Islander,1,347,2021-07-21T16:00:01.947
780,2021-01-14T00:00:00.000,Native Hawaiian or Other Pacific Islander,8,355,2021-07-21T16:00:01.947
781,2021-01-15T00:00:00.000,Native Hawaiian or Other Pacific Islander,3,358,2021-07-21T16:00:01.947
782,2021-01-16T00:00:00.000,Native Hawaiian or Other Pacific Islander,3,361,2021-07-21T16:00:01.947
783,2021-01-17T00:00:00.000,Native Hawaiian or Other Pacific Islander,1,362,2021-07-21T16:00:01.947
784,2021-01-18T00:00:00.000,Native Hawaiian or Other Pacific Islander,0,362,2021-07-21T16:00:01.947
785,2021-01-19T00:00:00.000,Native Hawaiian or Other Pacific Islander,4,366,2021-07-21T16:00:01.947
786,2021-01-20T00:00:00.000,Native Hawaiian or Other Pacific Islander,5,371,2021-07-21T16:00:01.947
787,2021-01-21T00:00:00.000,Native Hawaiian or Other Pacific Islander,3,374,2021-07-21T16:00:01.947
788,2021-01-22T00:00:00.000,Native Hawaiian or Other Pacific Islander,2,376,2021-07-21T16:00:01.947
789,2021-01-23T00:00:00.000,Native Hawaiian or Other Pacific Islander,0,376,2021-07-21T16:00:01.947
790,2021-01-24T00:00:00.000,Native Hawaiian or Other Pacific Islander,0,376,2021-07-21T16:00:01.947
791,2021-01-25T00:00:00.000,Native Hawaiian or Other Pacific Islander,1,377,2021-07-21T16:00:01.947
792,2021-01-26T00:00:00.000,Native Hawaiian or Other Pacific Islander,3,380,2021-07-21T16:00:01.947
793,2021-01-27T00:00:00.000,Native Hawaiian or Other Pacific Islander,1,381,2021-07-21T16:00:01.947
794,2021-01-28T00:00:00.000,Native Hawaiian or Other Pacific Islander,1,382,2021-07-21T16:00:01.947
795,2021-01-29T00:00:00.000,Native Hawaiian or Other Pacific Islander,4,386,2021-07-21T16:00:01.947
796,2021-01-30T00:00:00.000,Native Hawaiian or Other Pacific Islander,1,387,2021-07-21T16:00:01.947
797,2021-01-31T00:00:00.000,Native Hawaiian or Other Pacific Islander,1,388,2021-07-21T16:00:01.947
798,2021-02-01T00:00:00.000,Native Hawaiian or Other Pacific Islander,0,388,2021-07-21T16:00:01.947
799,2021-02-02T00:00:00.000,Native Hawaiian or Other Pacific Islander,1,389,2021-07-21T16:00:01.947
800,2021-02-03T00:00:00.000,Native Hawaiian or Other Pacific Islander,0,389,2021-07-21T16:00:01.947
801,2021-02-04T00:00:00.000,Native Hawaiian or Other Pacific Islander,1,390,2021-07-21T16:00:01.947
802,2021-02-05T00:00:00.000,Native Hawaiian or Other Pacific Islander,0,390,2021-07-21T16:00:01.947
803,2021-02-06T00:00:00.000,Native Hawaiian or Other Pacific Islander,0,390,2021-07-21T16:00:01.947
804,2021-02-07T00:00:00.000,Native Hawaiian or Other Pacific Islander,0,390,2021-07-21T16:00:01.947
805,2021-02-08T00:00:00.000,Native Hawaiian or Other Pacific Islander,0,390,2021-07-21T16:00:01.947
806,2021-02-09T00:00:00.000,Native Hawaiian or Other Pacific Islander,0,390,2021-07-21T16:00:01.947
807,2021-02-10T00:00:00.000,Native Hawaiian or Other Pacific Islander,0,390,2021-07-21T16:00:01.947
808,2021-02-11T00:00:00.000,Native Hawaiian or Other Pacific Islander,1,391,2021-07-21T16:00:01.947
809,2021-02-12T00:00:00.000,Native Hawaiian or Other Pacific Islander,2,393,2021-07-21T16:00:01.947
810,2021-02-13T00:00:00.000,Native Hawaiian or Other Pacific Islander,0,393,2021-07-21T16:00:01.947
811,2021-02-14T00:00:00.000,Native Hawaiian or Other Pacific Islander,2,395,2021-07-21T16:00:01.947
812,2021-02-15T00:00:00.000,Native Hawaiian or Other Pacific Islander,0,395,2021-07-21T16:00:01.947
813,2021-02-16T00:00:00.000,Native Hawaiian or Other Pacific Islander,0,395,2021-07-21T16:00:01.947
814,2021-02-17T00:00:00.000,Native Hawaiian or Other Pacific Islander,0,395,2021-07-21T16:00:01.947
815,2021-02-18T00:00:00.000,Native Hawaiian or Other Pacific Islander,1,396,2021-07-21T16:00:01.947
816,2021-02-19T00:00:00.000,Native Hawaiian or Other Pacific Islander,0,396,2021-07-21T16:00:01.947
817,2021-02-20T00:00:00.000,Native Hawaiian or Other Pacific Islander,0,396,2021-07-21T16:00:01.947
818,2021-02-21T00:00:00.000,Native Hawaiian or Other Pacific Islander,0,396,2021-07-21T16:00:01.947
819,2021-02-22T00:00:00.000,Native Hawaiian or Other Pacific Islander,1,397,2021-07-21T16:00:01.947
820,2021-02-23T00:00:00.000,Native Hawaiian or Other Pacific Islander,0,397,2021-07-21T16:00:01.947
821,2021-02-24T00:00:00.000,Native Hawaiian or Other Pacific Islander,0,397,2021-07-21T16:00:01.947
822,2021-02-25T00:00:00.000,Native Hawaiian or Other Pacific Islander,0,397,2021-07-21T16:00:01.947
823,2021-02-26T00:00:00.000,Native Hawaiian or Other Pacific Islander,0,397,2021-07-21T16:00:01.947
824,2021-02-27T00:00:00.000,Native Hawaiian or Other Pacific Islander,0,397,2021-07-21T16:00:01.947
825,2021-02-28T00:00:00.000,Native Hawaiian or Other Pacific Islander,0,397,2021-07-21T16:00:01.947
826,2021-03-01T00:00:00.000,Native Hawaiian or Other Pacific Islander,0,397,2021-07-21T16:00:01.947
827,2021-03-02T00:00:00.000,Native Hawaiian or Other Pacific Islander,0,397,2021-07-21T16:00:01.947
828,2021-03-03T00:00:00.000,Native Hawaiian or Other Pacific Islander,0,397,2021-07-21T16:00:01.947
829,2021-03-04T00:00:00.000,Native Hawaiian or Other Pacific Islander,0,397,2021-07-21T16:00:01.947
830,2021-03-05T00:00:00.000,Native Hawaiian or Other Pacific Islander,1,398,2021-07-21T16:00:01.947
831,2021-03-06T00:00:00.000,Native Hawaiian or Other Pacific Islander,0,398,2021-07-21T16:00:01.947
832,2021-03-07T00:00:00.000,Native Hawaiian or Other Pacific Islander,0,398,2021-07-21T16:00:01.947
833,2021-03-08T00:00:00.000,Native Hawaiian or Other Pacific Islander,1,399,2021-07-21T16:00:01.947
834,2021-03-09T00:00:00.000,Native Hawaiian or Other Pacific Islander,1,400,2021-07-21T16:00:01.947
835,2021-03-10T00:00:00.000,Native Hawaiian or Other Pacific Islander,0,400,2021-07-21T16:00:01.947
836,2021-03-11T00:00:00.000,Native Hawaiian or Other Pacific Islander,0,400,2021-07-21T16:00:01.947
837,2021-03-12T00:00:00.000,Native Hawaiian or Other Pacific Islander,0,400,2021-07-21T16:00:01.947
838,2021-03-13T00:00:00.000,Native Hawaiian or Other Pacific Islander,2,402,2021-07-21T16:00:01.947
839,2021-03-14T00:00:00.000,Native Hawaiian or Other Pacific Islander,0,402,2021-07-21T16:00:01.947
840,2021-03-15T00:00:00.000,Native Hawaiian or Other Pacific Islander,3,405,2021-07-21T16:00:01.947
841,2021-03-16T00:00:00.000,Native Hawaiian or Other Pacific Islander,0,405,2021-07-21T16:00:01.947
842,2021-03-17T00:00:00.000,Native Hawaiian or Other Pacific Islander,1,406,2021-07-21T16:00:01.947
843,2021-03-18T00:00:00.000,Native Hawaiian or Other Pacific Islander,0,406,2021-07-21T16:00:01.947
844,2021-03-19T00:00:00.000,Native Hawaiian or Other Pacific Islander,1,407,2021-07-21T16:00:01.947
845,2021-03-20T00:00:00.000,Native Hawaiian or Other Pacific Islander,0,407,2021-07-21T16:00:01.947
846,2021-03-21T00:00:00.000,Native Hawaiian or Other Pacific Islander,1,408,2021-07-21T16:00:01.947
847,2021-03-22T00:00:00.000,Native Hawaiian or Other Pacific Islander,0,408,2021-07-21T16:00:01.947
848,2021-03-23T00:00:00.000,Native Hawaiian or Other Pacific Islander,1,409,2021-07-21T16:00:01.947
849,2021-03-24T00:00:00.000,Native Hawaiian or Other Pacific Islander,2,411,2021-07-21T16:00:01.947
850,2021-03-25T00:00:00.000,Native Hawaiian or Other Pacific Islander,0,411,2021-07-21T16:00:01.947
851,2021-03-26T00:00:00.000,Native Hawaiian or Other Pacific Islander,2,413,2021-07-21T16:00:01.947
852,2021-03-27T00:00:00.000,Native Hawaiian or Other Pacific Islander,0,413,2021-07-21T16:00:01.947
853,2021-03-28T00:00:00.000,Native Hawaiian or Other Pacific Islander,0,413,2021-07-21T16:00:01.947
854,2021-03-29T00:00:00.000,Native Hawaiian or Other Pacific Islander,0,413,2021-07-21T16:00:01.947
855,2021-03-30T00:00:00.000,Native Hawaiian or Other Pacific Islander,1,414,2021-07-21T16:00:01.947
856,2021-03-31T00:00:00.000,Native Hawaiian or Other Pacific Islander,0,414,2021-07-21T16:00:01.947
857,2021-04-01T00:00:00.000,Native Hawaiian or Other Pacific Islander,3,417,2021-07-21T16:00:01.947
858,2021-04-02T00:00:00.000,Native Hawaiian or Other Pacific Islander,4,421,2021-07-21T16:00:01.947
859,2021-04-03T00:00:00.000,Native Hawaiian or Other Pacific Islander,3,424,2021-07-21T16:00:01.947
860,2021-04-04T00:00:00.000,Native Hawaiian or Other Pacific Islander,0,424,2021-07-21T16:00:01.947
861,2021-04-05T00:00:00.000,Native Hawaiian or Other Pacific Islander,1,425,2021-07-21T16:00:01.947
862,2021-04-06T00:00:00.000,Native Hawaiian or Other Pacific Islander,0,425,2021-07-21T16:00:01.947
863,2021-04-07T00:00:00.000,Native Hawaiian or Other Pacific Islander,2,427,2021-07-21T16:00:01.947
864,2021-04-08T00:00:00.000,Native Hawaiian or Other Pacific Islander,0,427,2021-07-21T16:00:01.947
865,2021-04-09T00:00:00.000,Native Hawaiian or Other Pacific Islander,0,427,2021-07-21T16:00:01.947
866,2021-04-10T00:00:00.000,Native Hawaiian or Other Pacific Islander,1,428,2021-07-21T16:00:01.947
867,2021-04-11T00:00:00.000,Native Hawaiian or Other Pacific Islander,0,428,2021-07-21T16:00:01.947
868,2021-04-12T00:00:00.000,Native Hawaiian or Other Pacific Islander,1,429,2021-07-21T16:00:01.947
869,2021-04-13T00:00:00.000,Native Hawaiian or Other Pacific Islander,0,429,2021-07-21T16:00:01.947
870,2021-04-14T00:00:00.000,Native Hawaiian or Other Pacific Islander,0,429,2021-07-21T16:00:01.947
871,2021-04-15T00:00:00.000,Native Hawaiian or Other Pacific Islander,0,429,2021-07-21T16:00:01.947
872,2021-04-16T00:00:00.000,Native Hawaiian or Other Pacific Islander,1,430,2021-07-21T16:00:01.947
873,2021-04-17T00:00:00.000,Native Hawaiian or Other Pacific Islander,0,430,2021-07-21T16:00:01.947
874,2021-04-18T00:00:00.000,Native Hawaiian or Other Pacific Islander,1,431,2021-07-21T16:00:01.947
875,2021-04-19T00:00:00.000,Native Hawaiian or Other Pacific Islander,0,431,2021-07-21T16:00:01.947
876,2021-04-20T00:00:00.000,Native Hawaiian or Other Pacific Islander,0,431,2021-07-21T16:00:01.947
877,2021-04-21T00:00:00.000,Native Hawaiian or Other Pacific Islander,0,431,2021-07-21T16:00:01.947
878,2021-04-22T00:00:00.000,Native Hawaiian or Other Pacific Islander,1,432,2021-07-21T16:00:01.947
879,2021-04-23T00:00:00.000,Native Hawaiian or Other Pacific Islander,0,432,2021-07-21T16:00:01.947
880,2021-04-24T00:00:00.000,Native Hawaiian or Other Pacific Islander,0,432,2021-07-21T16:00:01.947
881,2021-04-25T00:00:00.000,Native Hawaiian or Other Pacific Islander,0,432,2021-07-21T16:00:01.947
882,2021-04-26T00:00:00.000,Native Hawaiian or Other Pacific Islander,5,437,2021-07-21T16:00:01.947
883,2021-04-27T00:00:00.000,Native Hawaiian or Other Pacific Islander,0,437,2021-07-21T16:00:01.947
884,2021-04-28T00:00:00.000,Native Hawaiian or Other Pacific Islander,1,438,2021-07-21T16:00:01.947
885,2021-04-29T00:00:00.000,Native Hawaiian or Other Pacific Islander,0,438,2021-07-21T16:00:01.947
886,2021-04-30T00:00:00.000,Native Hawaiian or Other Pacific Islander,1,439,2021-07-21T16:00:01.947
887,2021-05-01T00:00:00.000,Native Hawaiian or Other Pacific Islander,0,439,2021-07-21T16:00:01.947
888,2021-05-02T00:00:00.000,Native Hawaiian or Other Pacific Islander,0,439,2021-07-21T16:00:01.947
889,2021-05-03T00:00:00.000,Native Hawaiian or Other Pacific Islander,0,439,2021-07-21T16:00:01.947
890,2021-05-04T00:00:00.000,Native Hawaiian or Other Pacific Islander,1,440,2021-07-21T16:00:01.947
891,2021-05-05T00:00:00.000,Native Hawaiian or Other Pacific Islander,1,441,2021-07-21T16:00:01.947
892,2021-05-06T00:00:00.000,Native Hawaiian or Other Pacific Islander,0,441,2021-07-21T16:00:01.947
893,2021-05-07T00:00:00.000,Native Hawaiian or Other Pacific Islander,1,442,2021-07-21T16:00:01.947
894,2021-05-08T00:00:00.000,Native Hawaiian or Other Pacific Islander,0,442,2021-07-21T16:00:01.947
895,2021-05-09T00:00:00.000,Native Hawaiian or Other Pacific Islander,1,443,2021-07-21T16:00:01.947
896,2021-05-10T00:00:00.000,Native Hawaiian or Other Pacific Islander,0,443,2021-07-21T16:00:01.947
897,2021-05-11T00:00:00.000,Native Hawaiian or Other Pacific Islander,0,443,2021-07-21T16:00:01.947
898,2021-05-12T00:00:00.000,Native Hawaiian or Other Pacific Islander,0,443,2021-07-21T16:00:01.947
899,2021-05-13T00:00:00.000,Native Hawaiian or Other Pacific Islander,1,444,2021-07-21T16:00:01.947
900,2021-05-14T00:00:00.000,Native Hawaiian or Other Pacific Islander,0,444,2021-07-21T16:00:01.947
901,2021-05-15T00:00:00.000,Native Hawaiian or Other Pacific Islander,0,444,2021-07-21T16:00:01.947
902,2021-05-16T00:00:00.000,Native Hawaiian or Other Pacific Islander,0,444,2021-07-21T16:00:01.947
903,2021-05-17T00:00:00.000,Native Hawaiian or Other Pacific Islander,1,445,2021-07-21T16:00:01.947
904,2021-05-18T00:00:00.000,Native Hawaiian or Other Pacific Islander,2,447,2021-07-21T16:00:01.947
905,2021-05-19T00:00:00.000,Native Hawaiian or Other Pacific Islander,2,449,2021-07-21T16:00:01.947
906,2021-05-20T00:00:00.000,Native Hawaiian or Other Pacific Islander,1,450,2021-07-21T16:00:01.947
907,2021-05-21T00:00:00.000,Native Hawaiian or Other Pacific Islander,0,450,2021-07-21T16:00:01.947
908,2021-05-22T00:00:00.000,Native Hawaiian or Other Pacific Islander,0,450,2021-07-21T16:00:01.947
909,2021-05-23T00:00:00.000,Native Hawaiian or Other Pacific Islander,0,450,2021-07-21T16:00:01.947
910,2021-05-24T00:00:00.000,Native Hawaiian or Other Pacific Islander,0,450,2021-07-21T16:00:01.947
911,2021-05-25T00:00:00.000,Native Hawaiian or Other Pacific Islander,2,452,2021-07-21T16:00:01.947
912,2021-05-26T00:00:00.000,Native Hawaiian or Other Pacific Islander,0,452,2021-07-21T16:00:01.947
913,2021-05-27T00:00:00.000,Native Hawaiian or Other Pacific Islander,1,453,2021-07-21T16:00:01.947
914,2021-05-28T00:00:00.000,Native Hawaiian or Other Pacific Islander,0,453,2021-07-21T16:00:01.947
915,2021-05-29T00:00:00.000,Native Hawaiian or Other Pacific Islander,0,453,2021-07-21T16:00:01.947
916,2021-05-30T00:00:00.000,Native Hawaiian or Other Pacific Islander,0,453,2021-07-21T16:00:01.947
917,2021-05-31T00:00:00.000,Native Hawaiian or Other Pacific Islander,0,453,2021-07-21T16:00:01.947
918,2021-06-01T00:00:00.000,Native Hawaiian or Other Pacific Islander,1,454,2021-07-21T16:00:01.947
919,2021-06-02T00:00:00.000,Native Hawaiian or Other Pacific Islander,0,454,2021-07-21T16:00:01.947
920,2021-06-03T00:00:00.000,Native Hawaiian or Other Pacific Islander,1,455,2021-07-21T16:00:01.947
921,2021-06-04T00:00:00.000,Native Hawaiian or Other Pacific Islander,3,458,2021-07-21T16:00:01.947
922,2021-06-05T00:00:00.000,Native Hawaiian or Other Pacific Islander,1,459,2021-07-21T16:00:01.947
923,2021-06-06T00:00:00.000,Native Hawaiian or Other Pacific Islander,0,459,2021-07-21T16:00:01.947
924,2021-06-07T00:00:00.000,Native Hawaiian or Other Pacific Islander,1,460,2021-07-21T16:00:01.947
925,2021-06-08T00:00:00.000,Native Hawaiian or Other Pacific Islander,0,460,2021-07-21T16:00:01.947
926,2021-06-09T00:00:00.000,Native Hawaiian or Other Pacific Islander,0,460,2021-07-21T16:00:01.947
927,2021-06-10T00:00:00.000,Native Hawaiian or Other Pacific Islander,0,460,2021-07-21T16:00:01.947
928,2021-06-11T00:00:00.000,Native Hawaiian or Other Pacific Islander,0,460,2021-07-21T16:00:01.947
929,2021-06-12T00:00:00.000,Native Hawaiian or Other Pacific Islander,0,460,2021-07-21T16:00:01.947
930,2021-06-13T00:00:00.000,Native Hawaiian or Other Pacific Islander,0,460,2021-07-21T16:00:01.947
931,2021-06-14T00:00:00.000,Native Hawaiian or Other Pacific Islander,0,460,2021-07-21T16:00:01.947
932,2021-06-15T00:00:00.000,Native Hawaiian or Other Pacific Islander,1,461,2021-07-21T16:00:01.947
933,2021-06-16T00:00:00.000,Native Hawaiian or Other Pacific Islander,0,461,2021-07-21T16:00:01.947
934,2021-06-17T00:00:00.000,Native Hawaiian or Other Pacific Islander,1,462,2021-07-21T16:00:01.947
935,2021-06-18T00:00:00.000,Native Hawaiian or Other Pacific Islander,0,462,2021-07-21T16:00:01.947
936,2021-06-19T00:00:00.000,Native Hawaiian or Other Pacific Islander,0,462,2021-07-21T16:00:01.947
937,2021-06-20T00:00:00.000,Native Hawaiian or Other Pacific Islander,0,462,2021-07-21T16:00:01.947
938,2021-06-21T00:00:00.000,Native Hawaiian or Other Pacific Islander,0,462,2021-07-21T16:00:01.947
939,2021-06-22T00:00:00.000,Native Hawaiian or Other Pacific Islander,0,462,2021-07-21T16:00:01.947
940,2021-06-23T00:00:00.000,Native Hawaiian or Other Pacific Islander,0,462,2021-07-21T16:00:01.947
941,2021-06-24T00:00:00.000,Native Hawaiian or Other Pacific Islander,0,462,2021-07-21T16:00:01.947
942,2021-06-25T00:00:00.000,Native Hawaiian or Other Pacific Islander,0,462,2021-07-21T16:00:01.947
943,2021-06-26T00:00:00.000,Native Hawaiian or Other Pacific Islander,0,462,2021-07-21T16:00:01.947
944,2021-06-27T00:00:00.000,Native Hawaiian or Other Pacific Islander,0,462,2021-07-21T16:00:01.947
945,2021-06-28T00:00:00.000,Native Hawaiian or Other Pacific Islander,0,462,2021-07-21T16:00:01.947
946,2021-06-29T00:00:00.000,Native Hawaiian or Other Pacific Islander,1,463,2021-07-21T16:00:01.947
947,2021-06-30T00:00:00.000,Native Hawaiian or Other Pacific Islander,2,465,2021-07-21T16:00:01.947
948,2021-07-01T00:00:00.000,Native Hawaiian or Other Pacific Islander,2,467,2021-07-21T16:00:01.947
949,2021-07-02T00:00:00.000,Native Hawaiian or Other Pacific Islander,0,467,2021-07-21T16:00:01.947
950,2021-07-03T00:00:00.000,Native Hawaiian or Other Pacific Islander,0,467,2021-07-21T16:00:01.947
951,2021-07-04T00:00:00.000,Native Hawaiian or Other Pacific Islander,0,467,2021-07-21T16:00:01.947
952,2021-07-05T00:00:00.000,Native Hawaiian or Other Pacific Islander,0,467,2021-07-21T16:00:01.947
953,2021-07-06T00:00:00.000,Native Hawaiian or Other Pacific Islander,4,471,2021-07-21T16:00:01.947
954,2021-07-07T00:00:00.000,Native Hawaiian or Other Pacific Islander,1,472,2021-07-21T16:00:01.947
955,2021-07-08T00:00:00.000,Native Hawaiian or Other Pacific Islander,0,472,2021-07-21T16:00:01.947
956,2021-07-09T00:00:00.000,Native Hawaiian or Other Pacific Islander,1,473,2021-07-21T16:00:01.947
957,2021-07-10T00:00:00.000,Native Hawaiian or Other Pacific Islander,0,473,2021-07-21T16:00:01.947
958,2021-07-11T00:00:00.000,Native Hawaiian or Other Pacific Islander,0,473,2021-07-21T16:00:01.947
959,2021-07-12T00:00:00.000,Native Hawaiian or Other Pacific Islander,1,474,2021-07-21T16:00:01.947
960,2021-07-13T00:00:00.000,Native Hawaiian or Other Pacific Islander,0,474,2021-07-21T16:00:01.947
961,2021-07-14T00:00:00.000,Native Hawaiian or Other Pacific Islander,0,474,2021-07-21T16:00:01.947
962,2021-07-15T00:00:00.000,Native Hawaiian or Other Pacific Islander,4,478,2021-07-21T16:00:01.947
963,2021-07-16T00:00:00.000,Native Hawaiian or Other Pacific Islander,1,479,2021-07-21T16:00:01.947
964,2021-07-17T00:00:00.000,Native Hawaiian or Other Pacific Islander,1,480,2021-07-21T16:00:01.947
965,2020-03-13T00:00:00.000,White,3,7,2021-07-21T16:00:01.947
966,2020-03-14T00:00:00.000,White,5,12,2021-07-21T16:00:01.947
967,2020-03-15T00:00:00.000,White,6,18,2021-07-21T16:00:01.947
968,2020-03-16T00:00:00.000,White,20,38,2021-07-21T16:00:01.947
969,2020-03-17T00:00:00.000,White,12,50,2021-07-21T16:00:01.947
970,2020-03-18T00:00:00.000,White,6,56,2021-07-21T16:00:01.947
971,2020-03-19T00:00:00.000,White,8,64,2021-07-21T16:00:01.947
972,2020-03-20T00:00:00.000,White,9,73,2021-07-21T16:00:01.947
973,2020-03-21T00:00:00.000,White,5,78,2021-07-21T16:00:01.947
974,2020-03-22T00:00:00.000,White,8,86,2021-07-21T16:00:01.947
975,2020-03-23T00:00:00.000,White,10,96,2021-07-21T16:00:01.947
976,2020-03-24T00:00:00.000,White,13,109,2021-07-21T16:00:01.947
977,2020-03-25T00:00:00.000,White,9,118,2021-07-21T16:00:01.947
978,2020-03-26T00:00:00.000,White,10,128,2021-07-21T16:00:01.947
979,2020-03-27T00:00:00.000,White,7,135,2021-07-21T16:00:01.947
980,2020-03-28T00:00:00.000,White,4,139,2021-07-21T16:00:01.947
981,2020-03-29T00:00:00.000,White,0,139,2021-07-21T16:00:01.947
982,2020-03-30T00:00:00.000,White,8,147,2021-07-21T16:00:01.947
983,2020-03-31T00:00:00.000,White,15,162,2021-07-21T16:00:01.947
984,2020-04-01T00:00:00.000,White,6,168,2021-07-21T16:00:01.947
985,2020-04-02T00:00:00.000,White,8,176,2021-07-21T16:00:01.947
986,2020-04-03T00:00:00.000,White,5,181,2021-07-21T16:00:01.947
987,2020-04-04T00:00:00.000,White,3,184,2021-07-21T16:00:01.947
988,2020-04-05T00:00:00.000,White,2,186,2021-07-21T16:00:01.947
989,2020-04-06T00:00:00.000,White,12,198,2021-07-21T16:00:01.947
990,2020-04-07T00:00:00.000,White,7,205,2021-07-21T16:00:01.947
991,2020-04-08T00:00:00.000,White,23,228,2021-07-21T16:00:01.947
992,2020-04-09T00:00:00.000,White,20,248,2021-07-21T16:00:01.947
993,2020-04-10T00:00:00.000,White,3,251,2021-07-21T16:00:01.947
994,2020-04-11T00:00:00.000,White,3,254,2021-07-21T16:00:01.947
995,2020-04-12T00:00:00.000,White,2,256,2021-07-21T16:00:01.947
996,2020-04-13T00:00:00.000,White,3,259,2021-07-21T16:00:01.947
997,2020-04-14T00:00:00.000,White,5,264,2021-07-21T16:00:01.947
998,2020-04-15T00:00:00.000,White,3,267,2021-07-21T16:00:01.947
999,2020-04-16T00:00:00.000,White,6,273,2021-07-21T16:00:01.947
